e 	e	 
 t	 	t
 th	 t	h
d 	d	 
in	i	n
s 	s	 
t 	t	 
er	e	r
an	a	n
 the 	 th	e 
ou	o	u
, 	,	 
on	o	n
. 	.	 
y 	y	 
en	e	n
ing	in	g
o 	o	 
th	t	h
ar	a	r
ed 	e	d 
or	o	r
 h	 	h
al	a	l
re	r	e
st	s	t
of	o	f
a 	a	 
and 	an	d 
at	a	t
ed	e	d
ing 	ing	 
wa	w	a
er 	er	 
sh	s	h
 to 	 t	o 
om	o	m
el	e	l
is 	i	s 
ow	o	w
at 	a	t 
ch	c	h
il	i	l
it	i	t
wh	w	h
you	y	ou
es	e	s
i 	i	 
ac	a	c
gh	g	h
im	i	m
le	l	e
was 	wa	s 
for	f	or
ri	r	i
as	a	s
of 	of	 
l 	l	 
be	b	e
li	l	i
ha	h	a
he 	h	e 
oo	o	o
ir	i	r
en 	en	 
id	i	d
se	s	e
all	al	l
in 	in	 
 the	 th	e
ro	r	o
it 	i	t 
ve 	v	e 
wi	w	i
k 	k	 
ad	a	d
and	an	d
ic	i	c
ur	u	r
un	u	n
am	a	m
ere 	er	e 
an 	an	 
with	wi	th
on 	on	 
oul	ou	l
no	n	o
is	i	s
es 	e	s 
she 	sh	e 
bu	b	u
us	u	s
ol	o	l
sa	s	a
you 	you	 
ly 	l	y 
ver	v	er
ent	en	t
ab	a	b
ne	n	e
 that 	 th	at 
e th	e 	th
as 	a	s 
ag	a	g
fr	f	r
 to	 t	o
ould 	oul	d 
.  	. 	 
of the 	of	 the 
e t	e 	t
ill	il	l
up	u	p
e, 	e	, 
ap	a	p
oun	ou	n
os	o	s
int	in	t
his 	h	is 
pl	p	l
 m	 	m
em	e	m
et	e	t
ough	ou	gh
my 	m	y 
ion	i	on
ear	e	ar
 his 	 h	is 
if	i	f
con	c	on
now	n	ow
from	fr	om
out 	ou	t 
ak	a	k
one 	on	e 
ul	u	l
with 	with	 
ell	el	l
had 	ha	d 
op	o	p
be 	b	e 
but 	bu	t 
com	c	om
sp	s	p
ra	r	a
e. 	e	. 
for 	for	 
in the 	in	 the 
ad 	a	d 
were 	w	ere 
 they 	 the	y 
we 	w	e 
de	d	e
id 	i	d 
s, 	s	, 
oth	o	th
ch 	ch	 
ex	e	x
ed to 	ed	 to 
bl	b	l
or 	or	 
e.	e	.
igh	i	gh
ked 	k	ed 
al 	al	 
own	ow	n
cl	c	l
not 	no	t 
som	s	om
our	ou	r
y, 	y	, 
ed the 	ed	 the 
go	g	o
qu	q	u
do	d	o
loo	l	oo
ain	a	in
ct	c	t
her 	h	er 
 and 	 	and 
ent 	en	t 
out	ou	t
 th	 	th
. th	.	 th
ep	e	p
bac	b	ac
wor	w	or
ill 	ill	 
 he 	 h	e 
fe	f	e
all 	all	 
gr	g	r
ev	e	v
s. 	s	. 
et 	e	t 
ant	an	t
him	h	im
um	u	m
would 	w	ould 
ce 	c	e 
ir 	ir	 
ion 	i	on 
what 	wh	at 
 to the 	 to	 the 
ut	u	t
ard	ar	d
 i 	 	i 
le 	l	e 
ust 	us	t 
e to 	e t	o 
bo	b	o
your	you	r
lo	l	o
 this 	 th	is 
lik	li	k
have 	ha	ve 
ay	a	y
w 	w	 
. the 	.	 the 
on the 	on	 the 
at the 	at	 the 
der	d	er
di	d	i
 her 	 h	er 
mor	m	or
so 	s	o 
are 	ar	e 
res	re	s
ck	c	k
ter	t	er
ong	on	g
e the 	e th	e 
, and 	, 	and 
 them	 the	m
ath	a	th
know	k	now
. he 	. 	he 
sm	s	m
ru	r	u
ly	l	y
ow 	ow	 
could 	c	ould 
su	s	u
ang	an	g
pro	p	ro
per	p	er
si	s	i
, the 	,	 the 
urn	ur	n
her	h	er
mo	m	o
ed, 	ed	, 
was	wa	s
he	h	e
we	w	e
nt 	n	t 
over	o	ver
man	m	an
ey	e	y
ave 	a	ve 
f 	f	 
? 	?	 
ing the 	ing	 the 
sid	s	id
ound	oun	d
down	d	own
art	ar	t
off	of	f
e. 	e.	 
af	a	f
fin	f	in
ing to 	ing	 to 
s and 	s 	and 
sc	s	c
sel	s	el
ter 	t	er 
said	sa	id
s.	s	.
 their 	 the	ir 
o the 	o	 the 
av	a	v
ound 	oun	d 
just 	j	ust 
ast	a	st
 had 	 h	ad 
no 	n	o 
est	e	st
from 	from	 
me 	m	e 
pe	p	e
end	en	d
rough	r	ough
way	wa	y
 tim	 t	im
been 	be	en 
its 	it	s 
ver 	v	er 
your 	your	 
some	som	e
gu	g	u
ever	e	ver
ers 	er	s 
me	m	e
it was 	it 	was 
king 	k	ing 
fac	f	ac
by 	b	y 
im 	im	 
ell 	ell	 
ed. 	ed	. 
min	m	in
ally 	all	y 
other 	oth	er 
up 	up	 
like 	lik	e 
ed.	ed	.
don	d	on
se 	s	e 
ght 	gh	t 
fir	f	ir
 the 	 th	e 
sur	s	ur
ar 	ar	 
fi	f	i
ood 	oo	d 
jo	j	o
new	ne	w
our 	our	 
said 	sa	id 
do 	d	o 
befor	be	for
's 	'	s 
 that	 th	at
po	p	o
old 	ol	d 
ght	gh	t
 there 	 th	ere 
from the 	from	 the 
ay 	a	y 
so	s	o
self	sel	f
. i 	. 	i 
thing 	th	ing 
anc	an	c
ped 	p	ed 
and the 	and	 the 
itt	it	t
low	l	ow
if 	if	 
back	bac	k
, but 	, 	but 
 wh	 	wh
will 	w	ill 
did	d	id
ame 	am	e 
ake 	ak	e 
au	a	u
ation	at	ion
ful	f	ul
 her	 h	er
p 	p	 
back 	bac	k 
ight 	igh	t 
e and 	e 	and 
 tr	 t	r
wat	w	at
ach	a	ch
iv	i	v
ret	re	t
way 	wa	y 
not	no	t
ould	oul	d
att	at	t
arm	ar	m
es, 	es	, 
ant 	an	t 
act	ac	t
some 	som	e 
but	bu	t
into 	int	o 
br	b	r
ig	i	g
car	c	ar
about 	ab	out 
air	a	ir
 tw	 t	w
ast 	as	t 
 through	 th	rough
get 	g	et 
ight	igh	t
 though	 th	ough
pos	p	os
dr	d	r
cont	con	t
who 	wh	o 
n 	n	 
par	p	ar
looked 	loo	ked 
 have 	 h	ave 
ip	i	p
any	an	y
a m	a 	m
into the 	int	o the 
ost 	os	t 
again	ag	ain
st 	s	t 
ess	es	s
, he 	, 	he 
s of 	s 	of 
co	c	o
ain 	a	in 
ard 	ar	d 
ge 	g	e 
 thin	 th	in
, i 	, 	i 
ive 	i	ve 
th 	th	 
only 	on	ly 
a l	a 	l
est 	es	t 
ade 	ad	e 
gl	g	l
ed. 	ed.	 
ood	oo	d
by	b	y
for the 	for	 the 
s. 	s.	 
ea	e	a
mu	m	u
dis	d	is
can 	c	an 
ind	in	d
when 	wh	en 
did 	d	id 
more 	mor	e 
fl	f	l
ort	or	t
gre	g	re
ot	o	t
. she 	. 	she 
mar	m	ar
a c	a 	c
ely 	el	y 
el 	el	 
 she 	 	she 
ist	i	st
room	ro	om
ess 	es	s 
sw	s	w
want	w	ant
't 	'	t 
a h	a	 h
him 	him	 
 then 	 th	en 
ous	ou	s
pr	p	r
where 	wh	ere 
led 	l	ed 
wal	w	al
 them 	 them	 
ate 	at	e 
ck 	c	k 
any 	an	y 
 the t	 the 	t
ation 	at	ion 
app	ap	p
ass	as	s
whi	wh	i
ie	i	e
pri	p	ri
comp	com	p
ey 	e	y 
let	le	t
plac	pl	ac
read	re	ad
before 	befor	e 
e of 	e 	of 
 turn	 t	urn
ong 	ong	 
str	st	r
."	.	"
 him	 h	im
ed and 	ed 	and 
cr	c	r
ca	c	a
ick	ic	k
 of 	 	of 
to 	t	o 
with the 	with	 the 
ing, 	ing	, 
ack	ac	k
most 	m	ost 
pres	p	res
iz	i	z
er, 	er	, 
a b	a 	b
rem	re	m
a s	a 	s
y. 	y	. 
spe	sp	e
about	ab	out
beg	be	g
pu	p	u
lif	li	f
dd	d	d
old	ol	d
mov	mo	v
ph	p	h
..	.	.
see 	se	e 
get	g	et
pp	p	p
under	un	der
us 	u	s 
hear	h	ear
s the 	s	 the 
hel	h	el
bet	be	t
enc	en	c
ber	b	er
bel	b	el
ask	as	k
ok	o	k
! 	!	 
cre	c	re
ous 	ou	s 
ed his 	ed 	his 
dont 	don	t 
e that 	e th	at 
lef	le	f
man 	m	an 
clos	cl	os
hand	h	and
bre	b	re
s to 	s	 to 
cap	c	ap
well	w	ell
ile 	il	e 
even 	ev	en 
 too	 t	oo
; 	;	 
ros	ro	s
seem	se	em
am 	am	 
y.	y	.
des	d	es
g 	g	 
ite 	it	e 
the 	th	e 
still 	st	ill 
unt	un	t
after 	af	ter 
day	d	ay
fel	f	el
other	oth	er
every	ever	y
eyes 	ey	es 
come 	com	e 
ic 	ic	 
didnt 	did	nt 
knew	k	new
 two 	 tw	o 
right 	ri	ght 
 tow	 t	ow
had	ha	d
ple 	pl	e 
fri	f	ri
as he 	as 	he 
ice 	ic	e 
ge	g	e
ated 	at	ed 
mon	m	on
dar	d	ar
sk	s	k
ittle 	itt	le 
when	wh	en
very 	ver	y 
form	for	m
made 	m	ade 
which 	whi	ch 
." 	."	 
ind 	in	d 
cle	c	le
ity 	it	y 
few	fe	w
caus	ca	us
stop	st	op
rec	re	c
head	he	ad
aw	a	w
now 	now	 
es. 	es	. 
t of 	t 	of 
down 	down	 
wom	w	om
ll	l	l
ser	s	er
tt	t	t
ep 	ep	 
ther 	th	er 
go 	g	o 
ann	an	n
of his 	of	 his 
ing. 	ing	. 
col	c	ol
red	re	d
how 	h	ow 
year	y	ear
vo	v	o
side 	sid	e 
in a 	in 	a 
ack 	ac	k 
start	st	art
sh 	sh	 
il 	il	 
self 	self	 
son	s	on
own 	own	 
shed 	sh	ed 
beh	be	h
ree 	re	e 
light	li	ght
ke	k	e
end 	en	d 
rep	re	p
ing h	ing	 h
saw	sa	w
came 	c	ame 
a t	a	 t
ob	o	b
s were 	s 	were 
gn	g	n
right	ri	ght
open	op	en
can	c	an
e?	e	?
door	do	or
pul	p	ul
. i 	.	 i 
eng	en	g
bod	bo	d
sin	s	in
 ther	 th	er
inter	int	er
cor	c	or
ount	oun	t
able 	ab	le 
du	d	u
lat	l	at
never 	ne	ver 
as the 	as	 the 
know 	know	 
around 	ar	ound 
could	c	ould
 time 	 tim	e 
fer	f	er
y to 	y	 to 
a p	a 	p
fol	f	ol
ble	b	le
 then	 th	en
star	st	ar
bar	b	ar
ose 	os	e 
gg	g	g
ty 	t	y 
 to t	 to	 t
 tak	 t	ak
ance 	an	ce 
few 	few	 
mis	m	is
good 	g	ood 
ther	th	er
ure 	ur	e 
war	w	ar
by the 	by	 the 
my	m	y
lin	l	in
 think 	 thin	k 
ju	j	u
make 	m	ake 
watch	wat	ch
nex	ne	x
vi	v	i
look 	loo	k 
n't 	n	't 
ing.	ing	.
much 	mu	ch 
.  i 	.  	i 
ef	e	f
what	wh	at
in his 	in	 his 
smil	sm	il
ks 	k	s 
got 	go	t 
over 	o	ver 
something 	some	thing 
ment	m	ent
age 	ag	e 
run	r	un
with a 	with 	a 
peo	pe	o
cur	c	ur
ings 	ing	s 
word	wor	d
enough	en	ough
ed in 	ed 	in 
around	ar	ound
 they were 	 they 	were 
i h	i	 h
az	a	z
after	af	ter
m 	m	 
ste	st	e
he was 	he 	was 
both	b	oth
fron	fr	on
ence 	en	ce 
won	w	on
 this	 th	is
call	c	all
another 	an	other 
ild	il	d
ect	e	ct
, she 	, 	she 
ies 	i	es 
 through the 	 through	 the 
che	ch	e
head 	he	ad 
ly, 	l	y, 
imp	im	p
bro	b	ro
es.	es	.
sl	s	l
cu	c	u
looking 	loo	king 
 take 	 t	ake 
ing his 	ing	 his 
let 	le	t 
said, 	said	, 
sil	s	il
ship	sh	ip
y. 	y.	 
each 	ea	ch 
cam	c	am
mom	m	om
irl	ir	l
going to 	go	ing to 
 toward	 tow	ard
was the 	was	 the 
 he	 h	e
mat	m	at
becaus	be	caus
ys 	y	s 
wait	wa	it
ered 	er	ed 
ese 	es	e 
happ	ha	pp
well 	w	ell 
stor	st	or
ved 	v	ed 
secon	se	con
felt 	fel	t 
first 	fir	st 
light 	li	ght 
ah	a	h
leas	le	as
stand	st	and
sed 	s	ed 
nor	n	or
augh	au	gh
had been 	had 	been 
appear	app	ear
ry 	r	y 
ever 	ev	er 
, t	,	 t
 than	 th	an
sup	s	up
must 	m	ust 
ook	oo	k
wr	w	r
cer	c	er
air 	a	ir 
has 	ha	s 
day 	d	ay 
ool	oo	l
would be 	would 	be 
away 	a	way 
dec	de	c
dri	d	ri
ure	u	re
rect	re	ct
should 	sh	ould 
a f	a 	f
left 	lef	t 
ble 	bl	e 
ting 	t	ing 
oc	o	c
follow	fol	low
asked 	as	ked 
mak	m	ak
acros	ac	ros
cour	c	our
people 	peo	ple 
emp	em	p
ily 	il	y 
comm	com	m
i have 	i	 have 
 to be 	 to 	be 
part	p	art
might 	m	ight 
pic	p	ic
quick	qu	ick
expl	ex	pl
men 	m	en 
 tal	 t	al
e.  	e	.  
contin	cont	in
girl	g	irl
 too 	 to	o 
though	th	ough
?"	?	"
vis	v	is
stu	st	u
eas	e	as
ci	c	i
 ch	 	ch
ning 	n	ing 
may	m	ay
capt	cap	t
ted 	t	ed 
 was 	 	was 
pa	p	a
small 	sm	all 
son 	s	on 
step	st	ep
der 	d	er 
being 	be	ing 
how	h	ow
. it 	. 	it 
reach	re	ach
point	po	int
ry	r	y
continu	contin	u
abl	ab	l
return	ret	urn
real	re	al
 than 	 th	an 
ail	a	il
need	ne	ed
face 	fac	e 
ct 	c	t 
off 	off	 
long	l	ong
friend	fri	end
while 	wh	ile 
find 	fin	d 
 you 	 	you 
even	ev	en
fort	for	t
answ	an	sw
minut	min	ut
flo	f	lo
lar	l	ar
feel	fe	el
last 	l	ast 
me. 	m	e. 
without 	with	out 
door 	do	or 
 the s	 the 	s
vel	v	el
ine 	in	e 
once 	on	ce 
wo 	w	o 
i had 	i	 had 
lip	li	p
a few 	a 	few 
ng	n	g
would	w	ould
cas	c	as
ving 	v	ing 
 he 	 	he 
ed to the 	ed	 to the 
young	you	ng
pass	p	ass
land	l	and
 tra	 t	ra
i was 	i 	was 
i'	i	'
found 	f	ound 
fath	f	ath
 it 	 	it 
 tri	 t	ri
thing	th	ing
er. 	er	. 
mi	m	i
cent	c	ent
ed her 	ed 	her 
worl	wor	l
she was 	she 	was 
many 	man	y 
sign	si	gn
over the 	over	 the 
bri	b	ri
on his 	on	 his 
quest	qu	est
ve	v	e
hou	h	ou
dif	d	if
ream	re	am
ma	m	a
stru	st	ru
night	n	ight
long 	l	ong 
little 	l	ittle 
sor	s	or
here 	h	ere 
new 	new	 
mil	m	il
er and 	er 	and 
add	ad	d
slow	s	low
ff	f	f
,"	,	"
alway	al	way
arr	ar	r
ed that 	ed	 that 
stood 	st	ood 
t to 	t	 to 
help	hel	p
pre	p	re
direct	di	rect
wind	w	ind
body 	bod	y 
ash	a	sh
near	ne	ar
me, 	m	e, 
exc	ex	c
ie 	i	e 
of h	of	 h
t the 	t	 the 
as she 	as 	she 
really 	re	ally 
sure 	sur	e 
ot 	o	t 
dro	d	ro
alf	al	f
leg	le	g
s that 	s	 that 
ward	w	ard
 a 	 	a 
because 	becaus	e 
why 	wh	y 
 those 	 th	ose 
say	sa	y
ener	en	er
t, 	t	, 
it, 	it	, 
 they	 the	y
ed a 	ed 	a 
fam	f	am
 these 	 th	ese 
ook 	oo	k 
chang	ch	ang
ing. 	ing.	 
ung	un	g
e to	e t	o
both 	both	 
cra	c	ra
inn	in	n
ber 	b	er 
es and 	es 	and 
went 	w	ent 
ll 	ll	 
ke 	k	e 
front 	fron	t 
pleas	p	leas
it. 	it	. 
mr	m	r
remem	rem	em
ready 	read	y 
able	ab	le
betwe	bet	we
 te	 t	e
behind 	beh	ind 
gun	g	un
 what 	 	what 
first	fir	st
every 	ever	y 
....	..	..
also 	al	so 
will	w	ill
 that the 	 th	at the 
like th	lik	e th
 took 	 too	k 
lu	l	u
joh	jo	h
 hand	 h	and
laugh	l	augh
kill	k	ill
ide 	id	e 
kn	k	n
sol	s	ol
acc	ac	c
pow	p	ow
look	loo	k
began	beg	an
fre	f	re
dist	di	st
 thought 	 though	t 
de 	d	e 
 think	 thin	k
ed with 	ed 	with 
sen	s	en
ank	an	k
x 	x	 
re 	r	e 
ed by 	ed 	by 
' 	'	 
oh	o	h
repli	rep	li
cover	c	over
mind	min	d
s of the 	s 	of the 
med	m	ed
work	wor	k
sle	s	le
yn	y	n
er.	er	.
almost 	al	most 
pat	p	at
rol	ro	l
been	be	en
fle	f	le
e. he 	e. 	he 
bor	b	or
e, and 	e, 	and 
of her 	of	 her 
all the 	all	 the 
." "	." 	"
for a 	for 	a 
ing her 	ing	 her 
john	joh	n
was a 	was 	a 
ing and 	ing 	and 
ans 	an	s 
ing a 	ing 	a 
qui	qu	i
happen	happ	en
put 	pu	t 
ful 	ful	 
ition	it	ion
give 	g	ive 
ime 	im	e 
good	g	ood
b 	b	 
one of the 	one 	of the 
reas	re	as
?" 	?"	 
walked 	wal	ked 
ary 	ar	y 
always 	alway	s 
.  the 	. 	 the 
out of the 	out 	of the 
ched 	ch	ed 
 him 	 h	im 
e? 	e?	 
would have 	would 	have 
cat	c	at
wasnt 	was	nt 
ept 	ep	t 
ents 	ent	s 
youre 	your	e 
offic	off	ic
sn	s	n
sudd	su	dd
vic	v	ic
ish	i	sh
wall	w	all
s.  	s	.  
ment 	m	ent 
giv	g	iv
possi	pos	si
? i 	?	 i 
es. 	es.	 
ari	ar	i
it.	it	.
bab	b	ab
did not 	did 	not 
and then 	and	 then 
e,	e	,
 tell 	 t	ell 
able to 	abl	e to 
hand 	h	and 
you have 	you	 have 
se, 	se	, 
if you 	if 	you 
gave 	g	ave 
hor	h	or
sever	se	ver
s, and 	s, 	and 
 three 	 th	ree 
breath	bre	ath
abo	ab	o
a, 	a	, 
far 	f	ar 
ently 	ent	ly 
. there 	. th	ere 
cal	c	al
voice 	vo	ice 
rew	re	w
 try	 tr	y
sat 	s	at 
. they 	.	 they 
idd	id	d
miss	mis	s
men	m	en
mad	m	ad
down the 	down	 the 
ually 	u	ally 
plan	pl	an
sim	s	im
sun	s	un
ed at 	ed 	at 
such 	su	ch 
lic	li	c
he had 	he 	had 
young 	young	 
ed to	ed	 to
out of 	out 	of 
hom	h	om
want to 	want	 to 
ick 	ic	k 
ds 	d	s 
ger	g	er
ves 	v	es 
ort 	or	t 
just	ju	st
inv	in	v
on, 	on	, 
abb	ab	b
ext	ex	t
 of the 	 	of the 
char	ch	ar
e. the 	e.	 the 
already 	al	ready 
big	b	ig
ses 	se	s 
may 	m	ay 
next 	nex	t 
black 	bl	ack 
inc	in	c
met	m	et
guard	gu	ard
arri	ar	ri
**	*	*
port	p	ort
a little 	a l	ittle 
ats 	at	s 
stre	st	re
ster	st	er
up the 	up	 the 
away	a	way
belie	bel	ie
rip	ri	p
ly.	ly	.
keep	ke	ep
leav	le	av
nothing 	no	thing 
e-	e	-
show	sh	ow
sound	s	ound
ond	on	d
do you 	do 	you 
. we 	. 	we 
appro	ap	pro
det	d	et
back to 	back	 to 
e to the 	e t	o the 
aut	a	ut
. "	. 	"
alex	al	ex
room 	room	 
stra	st	ra
e they 	e th	ey 
high	h	igh
and t	and	 t
mou	m	ou
feet 	fe	et 
she	sh	e
 thought	 though	t
ay, 	a	y, 
surpri	sur	pri
complet	comp	let
pect	pe	ct
mag	m	ag
, they 	,	 they 
y and 	y 	and 
resp	re	sp
ult	ul	t
 there was 	 there 	was 
place 	plac	e 
more th	mor	e th
one. 	on	e. 
going 	go	ing 
less 	l	ess 
od	o	d
way, 	wa	y, 
differ	dif	fer
still	st	ill
la	l	a
but the 	but	 the 
ek	e	k
ole 	ol	e 
until	unt	il
list	li	st
ating 	at	ing 
. this 	. th	is 
ump	um	p
te	t	e
nam	n	am
clear	cle	ar
val	v	al
mean	me	an
say 	sa	y 
hop	h	op
about the 	about	 the 
order	or	der
pull	pul	l
build	bu	ild
. you 	. 	you 
pulled 	pul	led 
sy	s	y
quickly 	quick	ly 
wonder	won	der
in her 	in	 her 
great 	gre	at 
ank 	an	k 
walk	wal	k
with his 	with	 his 
 tru	 t	ru
sch	s	ch
mer	m	er
 he was 	 he 	was 
sudden	sudd	en
you, 	you	, 
she had 	she 	had 
full	ful	l
shad	sh	ad
question	quest	ion
will be 	will 	be 
nodd	no	dd
night 	n	ight 
red 	r	ed 
dra	d	ra
woman 	wom	an 
ner	n	er
lead	le	ad
ical 	ic	al 
es to 	es	 to 
bur	b	ur
notic	not	ic
realiz	real	iz
 chap	 ch	ap
itch	it	ch
need to 	ne	ed to 
couldnt 	could	nt 
. wh	.	 wh
across the 	acros	s the 
ass 	as	s 
out the 	out	 the 
count	c	ount
ed him	ed 	him
 we 	 	we 
ue 	u	e 
around the 	around	 the 
foo	f	oo
again 	ag	ain 
t and 	t 	and 
oulder	oul	der
itu	it	u
life 	lif	e 
reg	re	g
his	h	is
oup	ou	p
of a 	of 	a 
e. th	e.	 th
only	on	ly
 told 	 t	old 
ried 	ri	ed 
maybe 	may	be 
to	t	o
began to 	began	 to 
. he 	.	 he 
as they 	as	 they 
coming 	com	ing 
someone 	some	one 
tion	t	ion
behind	beh	ind
dam	d	am
believe 	belie	ve 
ce	c	e
remain	rem	ain
--	-	-
 the fir	 the 	fir
. it was 	. 	it was 
probab	pro	bab
nat	n	at
pur	p	ur
cert	cer	t
see th	se	e th
years 	year	s 
anything 	any	thing 
je	j	e
, that 	,	 that 
work 	wor	k 
ben	b	en
lor	l	or
 through 	 through	 
as i 	as 	i 
 said 	 	said 
cked 	c	ked 
num	n	um
rest	re	st
well, 	well	, 
yes, 	y	es, 
decid	dec	id
t of the 	t 	of the 
: 	:	 
at le	at 	le
ire 	ir	e 
sub	su	b
 tell	 t	ell
ric	ri	c
shoulder	sh	oulder
fing	f	ing
stat	st	at
vers	ver	s
be th	b	e th
strang	str	ang
insid	in	sid
e, but 	e, 	but 
ear 	ear	 
ed.  	ed	.  
row	r	ow
leave 	le	ave 
up and 	up	 and 
conf	con	f
en the 	en	 the 
press	pres	s
like a 	like 	a 
 but 	 	but 
pet	p	et
along	al	ong
ground	gr	ound
as a 	as 	a 
ed her	ed 	her
remember	remem	ber
ace 	ac	e 
squ	s	qu
play	pl	ay
eful	e	ful
spok	sp	ok
, then 	,	 then 
les 	le	s 
en, 	en	, 
round	r	ound
said.	said	.
finally 	fin	ally 
voic	vo	ic
saw 	saw	 
forc	for	c
lad	l	ad
cant 	c	ant 
iat	i	at
 trying to 	 try	ing to 
a mom	a m	om
open 	op	en 
set 	se	t 
saf	sa	f
since 	sin	ce 
dark 	dar	k 
 tom	 t	om
ously 	ous	ly 
keep 	ke	ep 
ors 	or	s 
sir	s	ir
ious 	i	ous 
in my 	in 	my 
ps 	p	s 
sear	se	ar
whil	wh	il
dou	d	ou
ed to be 	ed to 	be 
s?	s	?
ally	all	y
ground 	gr	ound 
water 	wat	er 
between	betwe	en
es of 	es 	of 
second 	secon	d 
put	p	ut
wood	w	ood
sist	si	st
are you 	are 	you 
death	de	ath
arn	ar	n
several 	sever	al 
 turned 	 turn	ed 
mind 	min	d 
person	per	son
it is 	it 	is 
ock	o	ck
cros	c	ros
ink	in	k
y-	y	-
allow	all	ow
used 	us	ed 
five 	fi	ve 
four 	f	our 
hard	h	ard
from his 	from	 his 
six	si	x
inform	in	form
fall	f	all
ing that 	ing	 that 
.  he 	. 	 he 
seen 	se	en 
sli	s	li
group	gr	oup
fill	f	ill
same 	s	ame 
soon 	so	on 
 their	 the	ir
bes	b	es
ward 	w	ard 
enter	ent	er
er. 	er.	 
ea 	e	a 
ik	i	k
 chapter 	 chap	ter 
ction	ct	ion
above 	abo	ve 
s. he 	s. 	he 
 hel	 h	el
much	mu	ch
. . 	. 	. 
rid	ri	d
st the 	st	 the 
del	d	el
hun	h	un
asked. 	ask	ed. 
getting 	get	ting 
cau	c	au
need 	ne	ed 
against	again	st
arm 	arm	 
ei	e	i
mount	m	ount
agg	ag	g
inst	in	st
expect	ex	pect
answer	answ	er
 no	 	no
rais	ra	is
bb	b	b
clu	cl	u
mr. 	mr	. 
 they 	 th	ey 
mem	m	em
 how 	 h	ow 
t. 	t	. 
against 	again	st 
s. the 	s	. the 
and i 	and 	i 
off the 	off	 the 
ident	id	ent
don't 	don	't 
when he 	when	 he 
shar	sh	ar
itting 	itt	ing 
everything 	every	thing 
fur	f	ur
d, 	d	, 
pret	p	ret
probably 	probab	ly 
ons 	on	s 
which	whi	ch
stopped 	stop	ped 
dav	d	av
fu	f	u
white 	wh	ite 
ly. 	ly	. 
hum	h	um
use 	us	e 
00	0	0
pal	p	al
until 	unt	il 
imb	im	b
imag	im	ag
stand 	st	and 
standing 	stand	ing 
speak	spe	ak
does	do	es
you are 	you 	are 
turn	t	urn
two 	t	wo 
gener	g	ener
unn	un	n
ial 	i	al 
oft	of	t
less	l	ess
heard 	hear	d 
gra	g	ra
chil	ch	il
we have 	we 	have 
ement	em	ent
e!	e	!
 ter	 t	er
vie	v	ie
famil	fam	il
find	fin	d
didn't 	did	n't 
view	vie	w
brough	b	rough
dres	d	res
is the 	is	 the 
aim	a	im
sar	s	ar
ess. 	es	s. 
 in 	 	in 
yell	y	ell
bra	b	ra
 toge	 to	ge
cloth	cl	oth
ed it 	ed 	it 
ian 	i	an 
world 	worl	d 
'd 	'	d 
bas	b	as
 that was 	 that 	was 
rock	ro	ck
if he 	if	 he 
fect	fe	ct
e. i 	e. 	i 
hu	h	u
fire	fi	re
. but 	. 	but 
? he 	?	 he 
word 	wor	d 
whe	wh	e
knew 	knew	 
glanc	gl	anc
dang	d	ang
i think 	i	 think 
wanted to 	want	ed to 
mus	m	us
now, 	now	, 
one, 	on	e, 
. his 	. 	his 
move 	mo	ve 
ts 	t	s 
uni	un	i
draw	dra	w
others 	oth	ers 
ing her	ing	 her
stair	st	air
beaut	be	aut
ly. 	ly.	 
best 	b	est 
quite 	qu	ite 
grabb	gr	abb
want 	w	ant 
looked at 	looked 	at 
on a 	on 	a 
perha	per	ha
cut	c	ut
explain	expl	ain
called 	call	ed 
moved 	mov	ed 
****	**	**
le, 	le	, 
hur	h	ur
seemed 	seem	ed 
known	know	n
lets 	let	s 
ject	j	ect
feel 	fe	el 
sure	su	re
on her 	on	 her 
captain 	capt	ain 
everyone 	every	one 
 to his 	 to 	his 
ia 	i	a 
approach	appro	ach
went	w	ent
 hear	 h	ear
em 	em	 
moment	mom	ent
icul	ic	ul
ran	r	an
whis	wh	is
wil	w	il
break	bre	ak
. he was 	. he 	was 
adv	ad	v
although	al	though
of them 	of	 them 
deep 	de	ep 
it. 	it.	 
manag	man	ag
half	h	alf
 thing	 th	ing
se. 	se	. 
kind 	k	ind 
more than 	more th	an 
ling 	l	ing 
immed	im	med
stro	st	ro
ign	ig	n
path	p	ath
e, the 	e	, the 
bul	bu	l
listen	list	en
cho	ch	o
drop	dro	p
control	cont	rol
side of the 	side 	of the 
 head	 he	ad
better 	bet	ter 
scar	sc	ar
prom	pr	om
bott	bo	tt
attent	att	ent
cha	ch	a
sett	se	tt
apped 	ap	ped 
ven	v	en
 had	 h	ad
act 	ac	t 
floor	flo	or
dem	d	em
ris 	r	is 
amp	am	p
ed in the 	ed 	in the 
past	p	ast
 toward the 	 toward	 the 
road	ro	ad
ity	it	y
learn	le	arn
name 	n	ame 
know wh	know	 wh
ak 	a	k 
slowly 	slow	ly 
lou	l	ou
peri	per	i
yea	y	ea
ement 	em	ent 
dg	d	g
love 	lo	ve 
weap	we	ap
window	wind	ow
, you 	, 	you 
feet	fe	et
if i 	if	 i 
yeah	yea	h
of cour	of 	cour
a th	a	 th
burn	b	urn
grand	gr	and
had to 	had	 to 
to the 	t	o the 
big 	big	 
 that he 	 that 	he 
against the 	against	 the 
t.	t	.
, and	, 	and
it's 	it	's 
school	sch	ool
hed 	h	ed 
bil	b	il
als 	al	s 
cir	c	ir
ed, and 	ed	, and 
should	sh	ould
ys	y	s
 talk	 tal	k
se.	se	.
- 	-	 
fear	f	ear
're 	'	re 
ris	ri	s
i'm 	i'	m 
eric	er	ic
me to 	m	e to 
woman	wom	an
a.	a	.
,'	,	'
stay 	st	ay 
," 	,"	 
prot	pro	t
ran 	r	an 
s in 	s 	in 
pit	p	it
iful	if	ul
rad	r	ad
house 	hou	se 
held 	hel	d 
enn	en	n
edge 	ed	ge 
 thats 	 that	s 
 how	 h	ow
tor	t	or
hold	h	old
could not 	could 	not 
mur	m	ur
clo	cl	o
agre	ag	re
cess	c	ess
morn	mor	n
dead	de	ad
quiet	qui	et
sleep	sle	ep
said. 	said	. 
 they had 	 they 	had 
consid	con	sid
suddenly 	sudden	ly 
land 	l	and 
scream	sc	ream
blood	bl	ood
ed at the 	ed 	at the 
kept 	k	ept 
fire 	fir	e 
lean	le	an
outsid	out	sid
fast	f	ast
 things 	 th	ings 
in h	in	 h
see	se	e
sci	sc	i
nt	n	t
proble	pro	ble
said. 	said.	 
a lar	a l	ar
ez	e	z
e, he 	e, 	he 
ask 	as	k 
sound 	s	ound 
sus	s	us
small	sm	all
rif	ri	f
liv	li	v
ouch	ou	ch
a lo	a 	lo
done 	d	one 
ally, 	all	y, 
swe	s	we
dark	dar	k
enough 	enough	 
dead 	de	ad 
dur	d	ur
d'	d	'
?" "	?" 	"
far	f	ar
 tre	 t	re
e. she 	e. 	she 
vid	v	id
s, but 	s, 	but 
sat	s	at
har	h	ar
rist	ri	st
ing for 	ing 	for 
umbl	um	bl
of their 	of	 their 
found	f	ound
climb	cl	imb
before th	befor	e th
job	jo	b
we were 	we 	were 
heav	he	av
back to the 	back	 to the 
ing in 	ing 	in 
sive 	si	ve 
days 	day	s 
grow	gr	ow
 my 	 	my 
immediat	immed	iat
of them	of	 them
ounc	oun	c
have been 	have 	been 
under 	un	der 
second	secon	d
began 	beg	an 
gon	g	on
 took	 too	k
in this 	in	 this 
started 	start	ed 
box	bo	x
a cou	a c	ou
fiel	fi	el
zz	z	z
ition 	it	ion 
enough to 	enough	 to 
read 	re	ad 
 as 	 	as 
father 	fath	er 
last	l	ast
never	ne	ver
no one 	no 	one 
e."	e.	"
book	b	ook
ago	ag	o
became 	be	came 
forward	for	ward
 sh	 	sh
large 	lar	ge 
import	imp	ort
stri	st	ri
rap	r	ap
ed for 	ed 	for 
 thir	 th	ir
mann	man	n
exact	ex	act
mir	m	ir
og	o	g
someth	some	th
e tim	e t	im
, to 	,	 to 
better	bet	ter
ept	ep	t
command	comm	and
agn	ag	n
anyone 	any	one 
eir 	e	ir 
pap	p	ap
escap	es	cap
sitting 	s	itting 
minutes 	minut	es 
.'	.	'
could be 	could 	be 
blood 	bl	ood 
water	wat	er
 thre	 th	re
of this 	of	 this 
fig	fi	g
wer	w	er
ones 	on	es 
wouldnt 	would	nt 
 twent	 tw	ent
atter	at	ter
sou	s	ou
por	p	or
ray	ra	y
black	bl	ack
reco	re	co
ing it 	ing 	it 
boy 	bo	y 
at least 	at le	ast 
ist 	is	t 
see the 	see th	e 
ian	i	an
seemed to 	seem	ed to 
in, 	in	, 
loc	lo	c
sam	s	am
words 	word	s 
ince 	in	ce 
up to 	up	 to 
mist	m	ist
iev	i	ev
edg	ed	g
obvi	ob	vi
ction 	ct	ion 
wear	w	ear
stom	st	om
brought 	brough	t 
 tran	 tr	an
bag	b	ag
ire	i	re
creat	cre	at
roll	ro	ll
certain	cert	ain
disappear	dis	appear
. and 	. 	and 
ely	el	y
whisper	whis	per
rang	r	ang
yet 	y	et 
mother 	m	other 
, a 	, 	a 
ual 	u	al 
face. 	fac	e. 
ise 	is	e 
, said 	, 	said 
ing him 	ing h	im 
ed my 	ed 	my 
blue 	bl	ue 
 hour	 h	our
event	ev	ent
rup	r	up
a and 	a 	and 
pie	p	ie
ies	i	es
int 	in	t 
pil	p	il
onto the 	on	to the 
inste	in	ste
beautiful	beaut	iful
call 	c	all 
ens	en	s
ing to the 	ing	 to the 
stepped 	step	ped 
bow	b	ow
ach 	a	ch 
of the t	of the 	t
 had been 	 had 	been 
interest	inter	est
 in the 	 	in the 
yp	y	p
you to 	you	 to 
suppos	sup	pos
hes 	h	es 
like the 	like th	e 
caught 	cau	ght 
ing him	ing	 him
when the 	when	 the 
mark	mar	k
mouth	mou	th
is a 	is 	a 
reached 	reach	ed 
something	some	thing
on my 	on 	my 
serv	ser	v
busin	bu	sin
who	wh	o
it to 	it	 to 
. she 	.	 she 
sho	sh	o
reli	re	li
into a 	into 	a 
equ	e	qu
ed by the 	ed 	by the 
along 	al	ong 
seen	se	en
street	stre	et
fif	f	if
boo	b	oo
corn	cor	n
s. th	s.	 th
have to 	have 	to 
fell 	f	ell 
mal	m	al
vill	v	ill
 the st	 the 	st
world	worl	d
be the 	be th	e 
ions 	ion	s 
enem	en	em
ering 	er	ing 
midd	m	idd
spect	spe	ct
e, i 	e, 	i 
you?	you	?
empt	emp	t
fight	f	ight
day, 	d	ay, 
ord	or	d
ess, 	es	s, 
ed. "	ed. 	"
it was	it 	was
peop	pe	op
rush	ru	sh
s, the 	s	, the 
of my 	of 	my 
lost 	l	ost 
 it was 	 	it was 
artagn	art	agn
gent	g	ent
when i 	when 	i 
artagnyn	artagn	yn
yet	y	et
d'artagnyn	d'	artagnyn
wif	wi	f
feeling 	feel	ing 
careful	car	eful
as if 	as 	if 
desc	des	c
 thing 	 th	ing 
 tar	 t	ar
 here 	 h	ere 
kne	k	ne
americ	am	eric
dred 	dr	ed 
scre	sc	re
y?	y	?
, his 	, 	his 
jam	j	am
um 	um	 
power	pow	er
whole 	wh	ole 
 has 	 h	as 
chair	ch	air
rel	re	l
, but	, 	but
ani	an	i
, this 	,	 this 
rich	ri	ch
ed their 	ed	 their 
ho	h	o
.' 	.'	 
shot 	sh	ot 
ying 	y	ing 
eyes	ey	es
doub	dou	b
ness 	n	ess 
with her 	with	 her 
org	or	g
batt	b	att
stud	stu	d
great	gre	at
ss	s	s
, and the 	, 	and the 
did you 	did 	you 
floor 	flo	or 
ory 	or	y 
 that i 	 that 	i 
ed them 	ed	 them 
alex 	alex	 
craf	cra	f
e;	e	;
fun	f	un
onc	on	c
 the c	 the 	c
lying 	ly	ing 
himself 	him	self 
camp	cam	p
low 	l	ow 
into his 	into 	his 
top	t	op
meet	me	et
ers. 	er	s. 
log	lo	g
mast	m	ast
recogn	reco	gn
shout	sh	out
 top	 to	p
fact	fac	t
past 	p	ast 
wher	wh	er
ed him 	ed 	him 
, so 	, 	so 
a large 	a lar	ge 
different 	differ	ent 
started to 	start	ed to 
enjo	en	jo
jack	j	ack
most	mo	st
simp	s	imp
stopp	stop	p
pan	p	an
ically 	ic	ally 
bal	b	al
prince 	pr	ince 
else 	el	se 
captain	capt	ain
and, 	and	, 
 toward 	 tow	ard 
looks 	loo	ks 
full 	full	 
ations 	ation	s 
gaz	g	az
john 	john	 
push	pu	sh
ship 	ship	 
live 	li	ve 
ed. the 	ed	. the 
speci	spe	ci
wel	w	el
across 	acros	s 
month	mon	th
mas	m	as
kno	k	no
 tried to 	 tri	ed to 
bir	b	ir
ier	i	er
raf	ra	f
  th	 	 th
of her	of	 her
not to 	not	 to 
book 	b	ook 
ed them	ed	 them
es the 	es	 the 
fa	f	a
short 	sh	ort 
met 	m	et 
a. 	a	. 
brok	bro	k
sal	s	al
respon	resp	on
prof	pr	of
at his 	at 	his 
ired 	ir	ed 
we are 	we 	are 
s? 	s?	 
surv	sur	v
 time to 	 tim	e to 
on. 	on	. 
vern	ver	n
hen	h	en
help 	help	 
ity. 	it	y. 
tim	t	im
in front 	in 	front 
ing to	ing	 to
cret	c	ret
become 	be	come 
 two	 tw	o
real 	re	al 
asked, 	ask	ed, 
four	f	our
stay	st	ay
running 	run	ning 
ah 	ah	 
myself	my	self
 hom	 h	om
understand	under	stand
later	lat	er
cern	cer	n
 he had 	 he 	had 
shu	sh	u
bed	b	ed
dream	d	ream
shook	sh	ook
up, 	up	, 
actually 	act	ually 
bear	be	ar
position	pos	ition
mel	m	el
lov	lo	v
that 	th	at 
wish	wi	sh
morning 	mor	ning 
kind of 	kind 	of 
dog	do	g
doct	do	ct
hands 	hand	s 
fortun	fort	un
e was 	e 	was 
on.	on	.
bene	ben	e
they 	th	ey 
pain	p	ain
 towards the 	 toward	s the 
beth 	be	th 
sum	s	um
ited 	it	ed 
alli	al	li
friend 	fri	end 
himself	him	self
perhaps 	perha	ps 
matter	mat	ter
shi	sh	i
lay 	l	ay 
green 	gre	en 
along the 	along	 the 
utter	ut	ter
ull	ul	l
as it 	as 	it 
per 	p	er 
dom	d	om
ed up 	ed 	up 
childr	chil	dr
gat	g	at
i could 	i 	could 
convers	con	vers
ple of 	pl	e of 
does 	do	es 
flow	f	low
so, 	so	, 
a moment	a mom	ent
 time. 	 tim	e. 
pretty 	pret	ty 
it?	it	?
s t	s	 t
chris 	ch	ris 
cast	c	ast
chanc	ch	anc
beneath	bene	ath
secur	se	cur
 there were 	 there 	were 
gott	go	tt
guard 	gu	ard 
ele	el	e
bey	be	y
conne	con	ne
into	int	o
y of 	y 	of 
crow	cr	ow
gi	g	i
.  she 	.  	she 
arms 	arm	s 
cop	c	op
er of the 	er 	of the 
rac	r	ac
ined 	in	ed 
i had	i h	ad
hour	h	our
soldi	sol	di
rop	ro	p
hon	h	on
knif	kn	if
noth	no	th
kid	k	id
  chapter 	 	 chapter 
darkn	dar	kn
a good 	a 	good 
picked 	pic	ked 
we can 	we 	can 
surround	sur	round
hal	h	al
close 	clos	e 
slight	s	light
ram	r	am
stone 	st	one 
energ	ener	g
claim	cl	aim
do not 	do 	not 
prepar	pre	par
 head 	 he	ad 
ug	u	g
a small 	a 	small 
ins 	in	s 
ers, 	er	s, 
between 	betwe	en 
hol	h	ol
comfort	com	fort
i thought 	i	 thought 
hall	h	all
ung 	ung	 
before the 	before th	e 
way to 	way	 to 
s,	s	,
me th	m	e th
shap	sh	ap
at, 	at	, 
wall 	w	all 
another	an	other
having 	ha	ving 
you can 	you 	can 
are th	ar	e th
def	de	f
fell	f	ell
when she 	when 	she 
city 	c	ity 
lord 	lor	d 
oper	op	er
reason	reas	on
ened 	en	ed 
ed t	ed	 t
vol	v	ol
gas	g	as
ed. th	ed.	 th
rick 	ri	ck 
entire 	ent	ire 
law	l	aw
ern	er	n
ax	a	x
wound	w	ound
attack	att	ack
shak	sh	ak
ves	v	es
? she 	?	 she 
respond	resp	ond
however	how	ever
e. i 	e.	 i 
pock	po	ck
gone 	g	one 
for him	for	 him
or, 	or	, 
... 	..	. 
inside 	in	side 
ing my 	ing 	my 
ed through the 	ed	 through the 
he could 	he 	could 
al, 	al	, 
ink 	in	k 
d the 	d	 the 
ing their 	ing	 their 
road 	ro	ad 
pac	p	ac
in their 	in	 their 
from her 	from	 her 
shadow	shad	ow
girl 	girl	 
forward 	for	ward 
unch	un	ch
entr	ent	r
rick	ri	ck
and they 	and	 they 
family 	fam	ily 
vel 	v	el 
middle 	midd	le 
shot	sh	ot
below	bel	ow
week	we	ek
bob	bo	b
shoo	sh	oo
cut 	cu	t 
pen	p	en
yes	y	es
bi	b	i
ed. he 	ed	. he 
stop 	stop	 
stuff	stu	ff
experi	ex	peri
ence. 	enc	e. 
rest 	res	t 
replied 	repli	ed 
search	sear	ch
lish	li	sh
wait 	wa	it 
walk 	wal	k 
umped 	um	ped 
phone 	ph	one 
rat	r	at
hang	h	ang
maj	ma	j
s in the 	s 	in the 
aff	af	f
siz	si	z
suc	su	c
him, 	him	, 
either 	ei	ther 
ought 	ough	t 
crew	cre	w
a man 	a m	an 
problem	proble	m
a was 	a 	was 
completely 	complet	ely 
deep	de	ep
him.	him	.
back and 	back 	and 
making 	mak	ing 
short	sh	ort
concern	con	cern
danger	dang	er
. a 	. 	a 
stood	st	ood
next	nex	t
believ	bel	iev
struct	stru	ct
 towards 	 toward	s 
incre	in	cre
wont 	won	t 
chest	ch	est
jump	j	ump
under the 	under	 the 
bit	b	it
nic	n	ic
s. i 	s. 	i 
amm	am	m
of t	of	 t
hard 	h	ard 
after the 	after	 the 
, which 	, 	which 
bad	b	ad
 taken 	 tak	en 
waiting 	wait	ing 
, but i 	, but 	i 
doesnt 	does	nt 
run 	run	 
again, 	again	, 
ov	o	v
anim	an	im
 thro	 th	ro
a long 	a l	ong 
a bit 	a b	it 
in and 	in 	and 
lock	lo	ck
ity, 	it	y, 
onto 	on	to 
meet 	me	et 
colle	col	le
please 	pleas	e 
ient 	i	ent 
and then	and	 then
pas	p	as
ens 	en	s 
nes	n	es
, who 	, 	who 
t. 	t.	 
care 	c	are 
ap 	ap	 
se. 	se.	 
oh, 	oh	, 
ry, 	r	y, 
s to the 	s	 to the 
, then	,	 then
women 	wom	en 
wid	w	id
shir	sh	ir
e this 	e th	is 
que	qu	e
clou	cl	ou
ek 	e	k 
etim	et	im
uck	u	ck
buil	bu	il
lab	l	ab
. what 	. 	what 
y was 	y 	was 
, it 	, 	it 
be t	b	e t
one of 	one 	of 
eyes. 	ey	es. 
ished 	i	shed 
fully 	ful	ly 
sigh	s	igh
express	ex	press
stret	st	ret
ious	i	ous
't	'	t
exactly 	exact	ly 
e." 	e."	 
* 	*	 
ing at 	ing 	at 
living 	li	ving 
got	go	t
phil	ph	il
river	ri	ver
cry	cr	y
vent	v	ent
 when 	 wh	en 
les	l	es
where the 	where 	the 
dev	de	v
ards 	ard	s 
. you 	.	 you 
jas	j	as
 asked 	 	asked 
spac	sp	ac
situ	s	itu
used to 	us	ed to 
i hear	i h	ear
part 	par	t 
orn	or	n
cold 	c	old 
point 	po	int 
earth	ear	th
sing	s	ing
fil	f	il
besid	bes	id
luck	lu	ck
if the 	if	 the 
 thr	 th	r
mountain	mount	ain
myself 	my	self 
er of 	er 	of 
ied 	i	ed 
ific	if	ic
check	che	ck
drew	d	rew
cab	c	ab
er was 	er 	was 
hold 	h	old 
you. 	you	. 
finish	fin	ish
. he had 	. he 	had 
attention	attent	ion
what i 	what 	i 
spir	sp	ir
es were 	es 	were 
band	b	and
pop	p	op
olf	ol	f
e's 	e	's 
main 	m	ain 
idea 	id	ea 
smile 	sm	ile 
ed on the 	ed 	on the 
destro	de	stro
ing in the 	ing 	in the 
nin	n	in
ing?	ing	?
. what 	.	 what 
sugg	su	gg
shif	sh	if
radi	rad	i
fast 	f	ast 
hell	h	ell
high 	high	 
ignor	ig	nor
oke 	ok	e 
gath	g	ath
rail	ra	il
warri	war	ri
.' '	.' 	'
bad 	b	ad 
gold	g	old
plat	pl	at
protect	prot	ect
ident 	id	ent 
ing with 	ing 	with 
person 	per	son 
working 	wor	king 
she could 	she 	could 
chas	ch	as
david 	dav	id 
walking 	wal	king 
!"	!	"
damn	dam	n
recogniz	recogn	iz
bly 	b	ly 
god	go	d
behind the 	behind	 the 
on and 	on 	and 
sinc	sin	c
bon	b	on
beth	be	th
iff	if	f
sent 	s	ent 
le. 	le	. 
slip	s	lip
direction	direct	ion
ing t	ing	 t
left	lef	t
 his	 h	is
 *	 	*
arrow	arr	ow
spr	sp	r
rece	rec	e
would not 	would 	not 
milit	mil	it
god 	go	d 
disc	dis	c
er to 	er	 to 
indi	in	di
nearly 	near	ly 
cle 	cl	e 
ured 	ur	ed 
arriv	arri	v
idea	id	ea
in.	in	.
end of the 	end 	of the 
sent	s	ent
s are 	s 	are 
west 	w	est 
 that 	 th	at 
doing 	do	ing 
es that 	es	 that 
pict	pic	t
syst	sy	st
 for 	 	for 
fra	fr	a
diff	dif	f
ance. 	anc	e. 
, or 	, 	or 
jour	j	our
kill 	k	ill 
force 	for	ce 
for his 	for	 his 
ed as 	ed 	as 
mother	m	other
 its 	 	its 
larg	lar	g
 im 	 	im 
you were 	you 	were 
upon 	up	on 
ett	et	t
warm	w	arm
anyth	any	th
antly 	ant	ly 
must be 	must 	be 
managed to 	manag	ed to 
fail	f	ail
ping 	p	ing 
spot	sp	ot
iti	it	i
moving 	mov	ing 
moment 	mom	ent 
lap	l	ap
start 	star	t 
ed the t	ed the 	t
 there, 	 ther	e, 
sail	sa	il
dir	d	ir
simply 	simp	ly 
it the 	it	 the 
brow	br	ow
was not 	was 	not 
but i 	but 	i 
19	1	9
you.	you	.
earli	ear	li
food 	f	ood 
! i 	!	 i 
mot	mo	t
ing.  	ing	.  
 trou	 tr	ou
him. 	him	. 
, though	,	 though
about to 	about	 to 
ed on 	ed 	on 
action	act	ion
in. 	in	. 
supp	sup	p
appar	ap	par
kitch	k	itch
fli	f	li
father	fath	er
e two 	e t	wo 
s. she 	s. 	she 
cross	cros	s
in her	in	 her
boat 	bo	at 
show 	sh	ow 
offe	of	fe
clud	clu	d
six 	six	 
ix	i	x
 time, 	 tim	e, 
e their 	e th	eir 
doz	do	z
ation, 	ation	, 
ron	r	on
load	lo	ad
?'	?	'
eri	er	i
foc	f	oc
neck	ne	ck
sometim	som	etim
y.  	y	.  
eth	e	th
 there. 	 ther	e. 
age. 	ag	e. 
war 	w	ar 
comb	com	b
guy 	gu	y 
cannot 	can	not 
thought 	though	t 
om 	om	 
right, 	right	, 
firs	fir	s
ches 	ch	es 
mans 	man	s 
ion of 	ion 	of 
angr	an	gr
mach	m	ach
ish 	i	sh 
us, 	us	, 
 where 	 wh	ere 
understand 	under	stand 
hav	ha	v
'll 	'	ll 
govern	go	vern
wind 	w	ind 
 ten 	 t	en 
. then 	. th	en 
omb	om	b
sharp	shar	p
 that, 	 that	, 
pract	pr	act
pol	p	ol
immediately 	immediat	ely 
priss	pri	ss
inde	in	de
wrong	wr	ong
cul	c	ul
deser	des	er
y the 	y	 the 
cav	c	av
board	bo	ard
inside th	insid	e th
e turn	e t	urn
lie 	li	e 
line 	lin	e 
ror	r	or
knowl	know	l
rust	ru	st
daugh	d	augh
next to 	nex	t to 
a couple of 	a cou	ple of 
 with 	 	with 
, and i 	, and 	i 
strange 	strang	e 
ren	r	en
 to her 	 to 	her 
enjoy	enjo	y
ient	i	ent
in that 	in	 that 
on the t	on the 	t
ed into the 	ed 	into the 
 to get 	 to 	get 
afra	a	fra
 is 	 	is 
emer	em	er
present	pres	ent
ants 	ant	s 
rolled 	rol	led 
poli	po	li
spoke 	spok	e 
might be 	might 	be 
hell 	h	ell 
ters 	ter	s 
jon	j	on
fect 	fe	ct 
has	h	as
her h	her	 h
came to 	cam	e to 
. i was 	. i 	was 
fro	f	ro
 the st 	 the 	st 
arch	ar	ch
ining 	in	ing 
? th	?	 th
number 	num	ber 
of him	of	 him
releas	re	leas
. there was 	. there 	was 
prison	pri	son
 to see 	 to 	see 
cham	ch	am
ation.	ation	.
blu	bl	u
you know	you 	know
ingly 	ing	ly 
unk	un	k
calm	cal	m
jac	j	ac
s;	s	;
kis	k	is
dropped 	drop	ped 
home 	hom	e 
ed. i 	ed. 	i 
wondered 	wonder	ed 
joe 	jo	e 
abil	ab	il
bers 	b	ers 
y, and 	y, 	and 
remember 	remem	ber 
den	d	en
youve 	you	ve 
consider	consid	er
 taking 	 tak	ing 
a moment 	a mom	ent 
one th	on	e th
what he 	what 	he 
 that they 	 that	 they 
 help	 hel	p
ggl	g	gl
"i 	"	i 
gam	g	am
vir	v	ir
ation. 	ation	. 
 talk 	 tal	k 
excit	exc	it
fish	fi	sh
an h	an	 h
cup	c	up
 thinking 	 thin	king 
saw the 	saw	 the 
e! 	e!	 
. she was 	. she 	was 
alt	al	t
foot	foo	t
, as 	, 	as 
dont	don	t
a. 	a.	 
 thous	 th	ous
ven 	v	en 
lay	l	ay
 turned to 	 turn	ed to 
suggest	sugg	est
motion	mo	tion
mean 	me	an 
streng	str	eng
fut	f	ut
conv	con	v
ing them 	ing	 them 
ale	al	e
flu	fl	u
selves 	sel	ves 
glas	gl	as
pushed 	pu	shed 
it is	it 	is
los	l	os
story 	stor	y 
an un	an 	un
guys 	gu	ys 
again.	again	.
space 	sp	ace 
eg	e	g
quick 	qu	ick 
and that 	and	 that 
i think	i	 think
instead 	inste	ad 
flash	fl	ash
passed 	pass	ed 
strong	str	ong
auth	au	th
ope 	op	e 
clair	cl	air
ending 	end	ing 
it and 	it 	and 
jer	j	er
elect	el	ect
away from the 	away 	from the 
straight 	stra	ight 
coffe	c	offe
fore	for	e
 turn 	 turn	 
discover	dis	cover
come to 	com	e to 
coun	c	oun
 to take 	 to	 take 
ed,	ed	,
iny 	in	y 
what was 	what 	was 
ed from the 	ed 	from the 
hic	h	ic
a long	a l	ong
essa	es	sa
do you	do 	you
possible	possi	ble
remained 	remain	ed 
le.	le	.
!'	!	'
 take th	 tak	e th
have a 	have 	a 
ed, but 	ed, 	but 
shall 	sh	all 
firm	fir	m
eat	e	at
, we 	, 	we 
eye 	ey	e 
shes 	sh	es 
natur	nat	ur
reve	re	ve
key	k	ey
ed from 	ed 	from 
if they 	if	 they 
pub	pu	b
princ	pr	inc
comput	comp	ut
born	bor	n
0 	0	 
adm	ad	m
ermin	er	min
certainly 	certain	ly 
 the two 	 the t	wo 
bol	b	ol
invol	inv	ol
pack	p	ack
amaz	am	az
teen 	te	en 
away, 	a	way, 
boy	bo	y
apart	ap	art
surviv	surv	iv
barely 	bar	ely 
tal	t	al
ond 	on	d 
ears 	ear	s 
carri	car	ri
area 	ar	ea 
. then	. th	en
information 	inform	ation 
car 	c	ar 
cru	c	ru
 ton	 t	on
yl	y	l
stup	st	up
imagin	imag	in
figure 	fig	ure 
you're 	you	're 
you will 	you 	will 
watch 	wat	ch 
out, 	out	, 
bed 	b	ed 
curr	cur	r
is that 	is	 that 
empty 	emp	ty 
sens	sen	s
spar	sp	ar
norm	nor	m
begin	beg	in
ed, the 	ed	, the 
. her 	. 	her 
friends 	friend	s 
over his 	over	 his 
s, he 	s, 	he 
leaned 	lean	ed 
metal 	met	al 
who had 	who 	had 
inside the 	inside th	e 
e through	e th	rough
 together 	 toge	ther 
 hav	 h	av
smiled 	smil	ed 
later 	lat	er 
ief	ie	f
warn	war	n
save 	sa	ve 
rom	r	om
priv	pri	v
youll 	you	ll 
wheel	whe	el
ready to 	read	y to 
dropp	dro	pp
house	hou	se
beside 	bes	ide 
heart 	hear	t 
said the 	said	 the 
awn	aw	n
secre	se	cre
 that she 	 that 	she 
soci	so	ci
step 	st	ep 
longer 	long	er 
on. 	on.	 
further 	fur	ther 
s. the 	s. th	e 
commun	comm	un
profess	prof	ess
lady 	lad	y 
back, 	back	, 
jose	jo	se
dad	d	ad
  i 	 	 i 
decided to 	decid	ed to 
phot	ph	ot
like to 	lik	e to 
s on the 	s 	on the 
kind	k	ind
vehic	ve	hic
gar	g	ar
cool	c	ool
secret	se	cret
cit	c	it
dr. 	dr	. 
 this is 	 this 	is 
m. 	m	. 
worked 	wor	ked 
lil	l	il
rest of the 	res	t of the 
rugg	ru	gg
lit 	li	t 
had a 	had 	a 
joseph	jose	ph
drag	dr	ag
alone 	al	one 
lim	l	im
here, 	her	e, 
jumped 	j	umped 
dge 	d	ge 
exist	ex	ist
rose 	ro	se 
da	d	a
san	s	an
. i dont 	. i 	dont 
mouth 	mou	th 
 together	 toge	ther
seat 	se	at 
street 	stre	et 
 twenty 	 twent	y 
ely, 	el	y, 
non	n	on
deli	del	i
 them. 	 them	. 
clear 	cle	ar 
ately 	at	ely 
man, 	man	, 
 there is 	 there 	is 
esit	es	it
outside 	out	side 
s with 	s 	with 
herself 	her	self 
es.  	es	.  
ton 	t	on 
perfect	per	fect
ator	at	or
when they 	when	 they 
bill	b	ill
best	be	st
avo	av	o
let me 	let 	me 
guess 	gu	ess 
an, 	an	, 
bast	b	ast
must have 	must 	have 
me and 	me 	and 
 yes, 	 	yes, 
beautiful 	beautiful	 
get the 	get	 the 
boys 	bo	ys 
 who 	 wh	o 
, but he 	, but 	he 
 times 	 tim	es 
needed to 	need	ed to 
repe	re	pe
fall 	f	all 
assum	ass	um
ce of 	ce 	of 
his eyes 	his 	eyes 
in an 	in 	an 
charg	char	g
produ	pro	du
e time 	e t	ime 
paint	pa	int
olog	ol	og
famili	famil	i
indic	ind	ic
at all	at 	all
dad 	d	ad 
if we 	if 	we 
gun 	gun	 
king	k	ing
continued 	continu	ed 
given 	giv	en 
gras	gr	as
left the 	lef	t the 
cum	c	um
surpris	surpri	s
grew	gre	w
 try to 	 tr	y to 
wide 	w	ide 
guards 	guard	s 
velop	vel	op
ers	er	s
ness	n	ess
ures 	ure	s 
d of 	d 	of 
engin	eng	in
card	c	ard
change 	chang	e 
west	we	st
except 	exc	ept 
ing up 	ing 	up 
oppos	op	pos
ing through the 	ing	 through the 
room, 	room	, 
fo	f	o
gen	g	en
money 	mon	ey 
within 	with	in 
early 	ear	ly 
again. 	again	. 
seat	se	at
've 	'	ve 
should be 	should 	be 
eag	e	ag
necess	ne	cess
pain 	p	ain 
e. "	e. 	"
 so 	 	so 
 travel	 tra	vel
from a 	from 	a 
bit 	b	it 
sem	se	m
 hun	 h	un
, and he 	, and 	he 
ley 	le	y 
wolf	w	olf
rug	ru	g
mid	m	id
shor	sh	or
and he 	and 	he 
okay, 	ok	ay, 
dim	d	im
time 	t	ime 
down and 	down	 and 
scen	sc	en
three 	th	ree 
barr	bar	r
! he 	!	 he 
 on the 	 	on the 
play 	pl	ay 
ing out 	ing 	out 
sight	s	ight
life. 	lif	e. 
arrived 	arri	ved 
ed out 	ed 	out 
ried to 	ri	ed to 
with her	with	 her
visi	vis	i
activ	act	iv
refle	re	fle
ity to 	it	y to 
soft	s	oft
even though	even	 though
quar	qu	ar
took 	t	ook 
of that 	of	 that 
report	rep	ort
receiv	rece	iv
here. 	her	e. 
at this 	at	 this 
dut	d	ut
fav	f	av
. we 	.	 we 
area	ar	ea
cryst	cry	st
hat	h	at
no, 	no	, 
grap	gr	ap
00 	00	 
piec	pie	c
boat	bo	at
plann	pl	ann
given	giv	en
among	am	ong
ahead 	a	head 
with him	with	 him
above the 	above 	the 
anything	any	thing
hid	h	id
 the time 	 the t	ime 
mari	mar	i
ended 	end	ed 
reached the 	reach	ed the 
espe	es	pe
rock 	ro	ck 
mission	miss	ion
shut	sh	ut
paul	pa	ul
on their 	on	 their 
as we 	as 	we 
e, she 	e, 	she 
brother	bro	ther
memor	mem	or
especi	espe	ci
whatever 	what	ever 
is not 	is 	not 
soon	so	on
micha	mi	cha
es of the 	es 	of the 
finished 	fin	ished 
a sing	a s	ing
 them.	 them	.
 theres 	 ther	es 
as well	as 	well
meant	me	ant
eld	el	d
?' 	?'	 
you? 	you?	 
stead	ste	ad
unch 	un	ch 
y? 	y?	 
visit	vis	it
ed?	ed	?
ous. 	ou	s. 
writ	wr	it
anyway	any	way
interrup	inter	rup
know what 	know 	what 
couldn't 	could	n't 
security 	secur	ity 
idden 	idd	en 
brief	bri	ef
im not 	im 	not 
me?	me	?
ith	i	th
weapon	weap	on
sof	s	of
s. they 	s.	 they 
. my 	. 	my 
at her 	at 	her 
attemp	att	emp
ty	t	y
dat	d	at
system	syst	em
ather 	ath	er 
contain	cont	ain
 the same 	 the s	ame 
eak 	ea	k 
sand	s	and
and his 	and 	his 
what the 	wh	at the 
search 	sear	ch 
 and	 	and
i can 	i 	can 
ham	ha	m
. its 	. 	its 
ired	i	red
wood 	w	ood 
hot	h	ot
it had 	it 	had 
acked 	ac	ked 
during the 	dur	ing the 
known 	known	 
sight 	s	ight 
power 	pow	er 
could see 	could 	see 
sit 	s	it 
burg	bur	g
fren	fr	en
rot	ro	t
sword 	s	word 
lig	li	g
ton	t	on
ale 	al	e 
stream	st	ream
military 	milit	ary 
er than 	er	 than 
foot 	foo	t 
colon	col	on
 when	 wh	en
eyes, 	ey	es, 
color	col	or
spent 	sp	ent 
hair	ha	ir
glass 	gl	ass 
rus	r	us
hill	h	ill
as though	as	 though
strong 	str	ong 
curi	cu	ri
discus	disc	us
effort	ef	fort
compan	comp	an
ense 	en	se 
afterno	after	no
was to 	was	 to 
shel	sh	el
this 	th	is 
whit	wh	it
shade 	sh	ade 
journe	jour	ne
him. 	him.	 
can't 	can	't 
okay	ok	ay
nav	n	av
board 	bo	ard 
consci	con	sci
police 	poli	ce 
fru	fr	u
river 	ri	ver 
matild	mat	ild
 what	 wh	at
grip	g	rip
ed me 	ed 	me 
aur	a	ur
wist	wi	st
ing me 	ing 	me 
before he 	before 	he 
,' said 	,'	 said 
emerg	emer	g
victor	vic	tor
nerv	ner	v
aircraf	air	craf
between the 	between	 the 
ing this 	ing	 this 
silence 	sil	ence 
carry	car	ry
tak	t	ak
awa	a	wa
front of 	fron	t of 
anna 	ann	a 
fingers 	fing	ers 
window 	wind	ow 
prissi 	priss	i 
smell	sm	ell
decis	dec	is
ies. 	i	es. 
prec	p	rec
centr	cent	r
somewhere 	some	where 
s."	s.	"
directly 	direct	ly 
s had 	s 	had 
side. 	sid	e. 
gold 	g	old 
elev	el	ev
different	differ	ent
a big	a b	ig
,' 	,'	 
ed this 	ed	 this 
bodi	bo	di
hadnt 	had	nt 
pon	p	on
fix	fi	x
detail	det	ail
position 	pos	ition 
over to 	over	 to 
it was a 	it was 	a 
intel	int	el
easily 	eas	ily 
occas	oc	cas
important	import	ant
case 	cas	e 
ospit	os	pit
s, i 	s, 	i 
miles 	mil	es 
e. they 	e.	 they 
body	bod	y
child	ch	ild
told 	t	old 
struggl	stru	ggl
block	bl	ock
makes 	mak	es 
ance, 	anc	e, 
steps 	step	s 
beginn	beg	inn
igh 	igh	 
en. 	en	. 
secret 	secre	t 
orig	or	ig
elain	el	ain
wasn't 	was	n't 
ing on the 	ing 	on the 
vari	v	ari
en.	en	.
rik 	ri	k 
lep	le	p
rib	ri	b
gab	g	ab
 tomor	 tom	or
particul	part	icul
es, and 	es	, and 
eu	e	u
sy 	s	y 
els 	el	s 
reveal	reve	al
rather 	ra	ther 
looked at the 	looked 	at the 
special 	speci	al 
slightly 	slight	ly 
her.	her	.
os 	o	s 
as soon 	as 	soon 
for her	for	 her
 talking 	 tal	king 
shop	sh	op
exam	ex	am
s!	s	!
wast	wa	st
reason 	reas	on 
ing at the 	ing 	at the 
opened the 	open	ed the 
ere was 	ere 	was 
accomp	ac	comp
en and 	en 	and 
ract	r	act
edge of the 	edge 	of the 
peter 	pet	er 
row 	r	ow 
design	des	ign
who was 	who 	was 
.  it 	.  	it 
cover 	co	ver 
rain 	ra	in 
gest	g	est
with an 	with 	an 
going to be 	going to 	be 
win	w	in
arrow 	arr	ow 
 than the 	 than	 the 
al. 	al	. 
distance 	dist	ance 
anch	an	ch
lax	la	x
ouch 	ou	ch 
emot	em	ot
 theyre 	 they	re 
pressed 	pres	sed 
at least	at le	ast
other, 	oth	er, 
speak 	sp	eak 
final 	fin	al 
hit 	h	it 
quiet 	qui	et 
entered the 	enter	ed the 
th, 	th	, 
dep	de	p
rain	ra	in
eks 	e	ks 
if she 	if 	she 
ston	st	on
destroy	destro	y
miss 	mis	s 
it? 	it?	 
lon	l	on
isnt 	is	nt 
simon 	sim	on 
chur	ch	ur
answered 	answ	ered 
fold	f	old
ject 	je	ct 
promis	prom	is
free 	f	ree 
soul	s	oul
e too 	e to	o 
geor	ge	or
y. th	y.	 th
frown	fr	own
tru	t	ru
nath	n	ath
blank	bl	ank
equip	equ	ip
angu	ang	u
dred	d	red
could have 	could 	have 
lift	lif	t
its	it	s
east	e	ast
ing of 	ing 	of 
drive 	dri	ve 
join	jo	in
staff	st	aff
viol	vi	ol
wore 	wor	e 
some of the 	some 	of the 
blow	bl	ow
of those 	of	 those 
at a 	at 	a 
spl	s	pl
wooden 	wood	en 
depart	de	part
claire 	clair	e 
rik	ri	k
hear 	hear	 
----	--	--
says 	sa	ys 
determin	det	ermin
 to do 	 to 	do 
studi	stu	di
chest 	ch	est 
sword	s	word
 thank 	 than	k 
 to a 	 to 	a 
istol	ist	ol
i am 	i 	am 
sort of 	sor	t of 
sense 	sen	se 
 hands 	 hand	s 
fight 	f	ight 
part of the 	par	t of the 
nei	ne	i
connect	conne	ct
out.	out	.
? asked 	?	 asked 
smoo	sm	oo
o, 	o	, 
defin	de	fin
dave 	d	ave 
weak	we	ak
ed. she 	ed. 	she 
was t	was	 t
 why 	 wh	y 
plan 	pl	an 
dress	dres	s
half 	half	 
const	con	st
broken 	brok	en 
includ	in	clud
building 	build	ing 
solut	sol	ut
clean	cle	an
suit	su	it
chief	ch	ief
imm	im	m
ion, 	ion	, 
ball	b	all
eful 	e	ful 
in. 	in.	 
relax	re	lax
year 	year	 
so i 	so 	i 
. that 	.	 that 
near the 	near	 the 
business 	busin	ess 
had the 	had	 the 
obviously 	obvi	ously 
zan	z	an
sque	squ	e
such a 	such 	a 
rout	r	out
was, 	wa	s, 
each other 	each 	other 
girls 	girl	s 
sorry 	sor	ry 
; the 	;	 the 
melod	mel	od
waited 	wait	ed 
army 	ar	my 
as well 	as 	well 
up. 	up	. 
look at 	look 	at 
watched 	watch	ed 
as if	as 	if
elean	ele	an
 hor	 h	or
stin	st	in
in t	in	 t
 happ	 h	app
remind	re	mind
amand	am	and
ress 	res	s 
knows 	know	s 
up.	up	.
ali	al	i
more. 	mor	e. 
bottom	bott	om
fal	f	al
out and 	out 	and 
later, 	lat	er, 
dont know	dont 	know
pocket	pock	et
experienc	experi	enc
aint 	ain	t 
d.	d	.
pt	p	t
demand	dem	and
gentle	gent	le
hi	h	i
safe 	saf	e 
cond	con	d
rag	r	ag
ed into 	ed 	into 
gro	g	ro
dinn	d	inn
ther, 	th	er, 
advent	adv	ent
nation	n	ation
lex	le	x
wanted 	want	ed 
adel	ad	el
for her 	for	 her 
aliv	al	iv
uc	u	c
desp	des	p
i heard 	i hear	d 
general 	gener	al 
not the 	not	 the 
ed. i 	ed.	 i 
one to 	on	e to 
forest	for	est
her, 	her	, 
paus	pa	us
provid	pro	vid
wiz	wi	z
 thank	 than	k
make th	mak	e th
drink	dr	ink
or the 	or	 the 
with my 	with 	my 
glow	g	low
up to the 	up	 to the 
oh 	oh	 
ely. 	el	y. 
al.	al	.
door and 	door 	and 
ander	and	er
ahead	a	head
a he	a h	e
post	po	st
shook his 	shook	 his 
leap	le	ap
wit	w	it
organ	org	an
ally. 	all	y. 
is, 	is	, 
ech	e	ch
ion of the 	ion 	of the 
 **	 	**
ably 	ab	ly 
headed 	head	ed 
origin	orig	in
ly the 	ly	 the 
now. 	now	. 
empl	em	pl
ities 	it	ies 
cold	c	old
so much 	so 	much 
phys	ph	ys
pay	p	ay
seconds 	secon	ds 
bru	b	ru
it would 	it 	would 
un 	un	 
i told 	i	 told 
deck	de	ck
either	ei	ther
art 	ar	t 
in the middle 	in the 	middle 
 not 	 	not 
ror 	r	or 
a single 	a sing	le 
ion and 	ion 	and 
weve 	we	ve 
prov	pro	v
patrick 	pat	rick 
needed 	need	ed 
 threw	 th	rew
ers and 	er	s and 
nothing	no	thing
invest	inv	est
y t	y	 t
eyes and 	eyes 	and 
d and 	d 	and 
arrang	arr	ang
s. i 	s.	 i 
sounds 	sound	s 
attack 	att	ack 
 hand 	 h	and 
nor 	n	or 
down, 	down	, 
umb	um	b
 them, 	 them	, 
flam	fl	am
before. 	befor	e. 
gett	get	t
ies, 	i	es, 
ed to his 	ed to 	his 
fair	f	air
.  we 	.  	we 
carefully 	careful	ly 
blad	bl	ad
remov	re	mov
straight	stra	ight
serge	ser	ge
ail 	a	il 
s for 	s 	for 
place. 	plac	e. 
comes 	com	es 
. they 	.	 they 
flight 	f	light 
stern	ster	n
over and 	over 	and 
what you 	what 	you 
difficul	diff	icul
herself	her	self
iri	i	ri
death 	death	 
ed. the 	ed. th	e 
thir	th	ir
deal 	de	al 
course 	cour	se 
after all	after 	all
heavy 	heav	y 
you. 	you.	 
willi	wil	li
late 	l	ate 
ety 	et	y 
all of 	all 	of 
no longer 	no 	longer 
ing? 	ing?	 
send 	s	end 
bath	b	ath
glo	g	lo
north 	nor	th 
yourself	your	self
food	f	ood
phillip	phil	lip
satis	sat	is
each	e	ach
most of the 	most 	of the 
pick	p	ick
eye	ey	e
y, but 	y, 	but 
replied. 	repli	ed. 
at that 	at	 that 
bright 	b	right 
she'd 	she	'd 
while th	whil	e th
seemed to be 	seem	ed to be 
, my 	, 	my 
civ	c	iv
** 	**	 
rible 	ri	ble 
gotten 	gott	en 
ing. the 	ing	. the 
messa	m	essa
looked up 	looked 	up 
made th	mad	e th
 there was no 	 there was 	no 
cri	c	ri
 trust 	 tr	ust 
rober	ro	ber
ed with the 	ed 	with the 
iss	is	s
confus	conf	us
full of 	full	 of 
 have to 	 have 	to 
 trip	 tri	p
us. 	us	. 
20	2	0
increas	incre	as
energy 	energ	y 
buck	bu	ck
scot	sc	ot
uniform	uni	form
ence, 	enc	e, 
question 	quest	ion 
ult 	ul	t 
ittl	itt	l
broke 	bro	ke 
poor 	po	or 
yeah, 	yeah	, 
peopl	peo	pl
for a moment	for 	a moment
catch	cat	ch
ert	er	t
dol	d	ol
jason 	jas	on 
 the tim	 the t	im
mike 	mi	ke 
opport	op	port
opportun	opport	un
runn	run	n
ional 	ion	al 
ed through	ed	 through
effect	ef	fect
, not 	, 	not 
bos	b	os
vell	v	ell
an in	an 	in
flew	fle	w
ed;	ed	;
what happen	what 	happen
lor 	l	or 
sun 	sun	 
bring 	br	ing 
when we 	when 	we 
whats 	what	s 
) 	)	 
admir	ad	mir
upon the 	up	on the 
hundred 	hun	dred 
each other	each 	other
are the 	are th	e 
sav	sa	v
ed with	ed 	with
eight	e	ight
voice. 	voic	e. 
has been 	has 	been 
 took a 	 took 	a 
 to make 	 to 	make 
   chapter 	 	  chapter 
 at 	 	at 
ceil	ce	il
 or 	 	or 
ys, 	y	s, 
island	is	land
ict	ic	t
possible 	possi	ble 
alth	al	th
pistol	p	istol
sounded 	sound	ed 
knife 	knif	e 
a had 	a	 had 
dragg	dr	agg
often 	oft	en 
at's 	at	's 
ator 	at	or 
south 	sou	th 
opened 	open	ed 
pick 	pic	k 
especially 	especi	ally 
deal	de	al
from my 	from 	my 
. there were 	. there 	were 
hy	h	y
again. 	again.	 
was still 	was 	still 
an old 	an 	old 
christ	ch	rist
sometimes 	sometim	es 
george 	geor	ge 
north	nor	th
exclaim	ex	claim
close to 	clos	e to 
drove 	dro	ve 
since th	sinc	e th
proper	pro	per
neck 	ne	ck 
set	se	t
ashed 	a	shed 
sky 	sk	y 
feat	fe	at
enemy 	enem	y 
hesit	h	esit
 tell me 	 tell 	me 
noticed 	notic	ed 
legs 	leg	s 
explos	expl	os
control 	control	 
danc	d	anc
attempt	att	empt
round 	r	ound 
ra 	r	a 
antic	ant	ic
rear 	re	ar 
shrugg	sh	rugg
will not 	will 	not 
 and the 	 	and the 
skin 	sk	in 
order 	or	der 
when you 	when 	you 
out to 	out	 to 
got to 	go	t to 
roo	r	oo
 half	 h	alf
s. "	s. 	"
level	le	vel
guess	gu	ess
on this 	on	 this 
near 	ne	ar 
children 	childr	en 
i've 	i'	ve 
separ	se	par
pot	po	t
we had 	we 	had 
 thes	 th	es
felt	fel	t
desper	des	per
exp	ex	p
alon	al	on
fine 	fin	e 
now.	now	.
van	v	an
relat	re	lat
pier	p	ier
lish 	li	sh 
hist	h	ist
blade 	bl	ade 
max	ma	x
sess	s	ess
respect	re	spect
ation. 	ation.	 
him and 	him	 and 
money	mon	ey
easy 	eas	y 
 touch	 t	ouch
 hed 	 h	ed 
ago 	ag	o 
 throw	 th	row
you and 	you 	and 
rubb	ru	bb
room. 	room	. 
die 	di	e 
out. 	out	. 
, there 	,	 there 
state 	st	ate 
perhap	perha	p
quickly	quick	ly
everything	every	thing
grew 	grew	 
sport	sp	ort
pound	p	ound
eight 	e	ight 
perfect 	per	fect 
sea 	se	a 
us.	us	.
ation of 	ation 	of 
le of 	le 	of 
craz	cra	z
ly and 	ly 	and 
angell 	ang	ell 
 the tru	 the t	ru
her eyes 	her 	eyes 
lie	li	e
offer	off	er
unfortun	un	fortun
way.	way	.
ing, and 	ing	, and 
 that?	 that	?
silent	sil	ent
followed 	follow	ed 
. i am 	. i 	am 
use	u	se
uten	ut	en
leng	l	eng
over to the 	over	 to the 
sleep 	sle	ep 
age, 	ag	e, 
what is 	what 	is 
mention	ment	ion
 trans	 tran	s
carried 	car	ried 
12	1	2
fad	f	ad
just as 	just 	as 
prou	pr	ou
develop	de	velop
ref	re	f
 he t	 h	e t
i'll 	i'	ll 
iously 	i	ously 
answer 	answ	er 
face, 	fac	e, 
ed that the 	ed	 that the 
clas	cl	as
grad	gr	ad
worry 	wor	ry 
on top	on	 top
!' 	!'	 
ate th	at	e th
way. 	way	. 
closed 	clos	ed 
realized 	realiz	ed 
possibl	possi	bl
polit	pol	it
chair 	ch	air 
camer	cam	er
president 	pres	ident 
wav	wa	v
ancient 	anc	ient 
with their 	with	 their 
caut	ca	ut
asle	as	le
unnel	unn	el
us to 	us	 to 
. it 	.	 it 
shoulder 	should	er 
office 	off	ice 
knew that 	knew	 that 
craw	cra	w
brother 	bro	ther 
en to 	en	 to 
flying 	f	lying 
announc	ann	ounc
net	ne	t
at and 	at 	and 
author	auth	or
company 	comp	any 
doubt	doub	t
lights 	light	s 
. im 	. 	im 
cent 	c	ent 
ual	u	al
lost	lo	st
jim	j	im
racha	ra	cha
 to their 	 to	 their 
responsi	respon	si
usually 	us	ually 
ost	o	st
roy	ro	y
spec	spe	c
," he 	,"	 he 
alin	al	in
laid 	la	id 
many	man	y
proc	pro	c
drif	dri	f
chuck	ch	uck
tain	t	ain
juli	ju	li
grat	gr	at
had been	had 	been
wrong 	wr	ong 
continued to 	continu	ed to 
able, 	able	, 
ing. i 	ing	. i 
 take the 	 take th	e 
a hun	a h	un
only one 	only 	one 
on her	on	 her
uge 	u	ge 
settled 	sett	led 
added 	add	ed 
following 	follow	ing 
really	re	ally
outside th	outsid	e th
. thats 	. th	ats 
warm 	w	arm 
complete 	complet	e 
wash	wa	sh
inking 	in	king 
es. the 	es	. the 
ry. 	r	y. 
 threat	 thre	at
magic	mag	ic
ni	n	i
down to 	down	 to 
mark 	mar	k 
cheek	che	ek
earth 	ear	th 
beyond	bey	ond
number	num	ber
golden 	gold	en 
russi	rus	si
of these 	of	 these 
clif	c	lif
alread	al	read
her. 	her	. 
nice 	n	ice 
seven 	se	ven 
issu	is	su
looking at 	looking 	at 
lead 	le	ad 
farm	f	arm
allow 	all	ow 
back.	back	.
eff	ef	f
bled 	bl	ed 
manny 	mann	y 
fat	f	at
clar	cl	ar
people	peop	le
intent	int	ent
slipped 	slip	ped 
forest 	for	est 
ordin	ord	in
in front of 	in 	front of 
should have 	should 	have 
ich 	i	ch 
ing them	ing	 them
item	it	em
hair 	ha	ir 
!" 	!"	 
?' '	?' 	'
check 	che	ck 
angel	ang	el
a big 	a big	 
are you	are 	you
pay 	p	ay 
conversation 	convers	ation 
 train	 tra	in
built 	buil	t 
crim	cr	im
appoint	ap	point
richard 	rich	ard 
rica 	ric	a 
group 	group	 
into her 	into 	her 
however, 	however	, 
surprised 	surpri	sed 
custom	cu	stom
 hou	 h	ou
lieuten	lie	uten
back into the 	back 	into the 
y that 	y	 that 
correct	cor	rect
, he was 	, he 	was 
cli	c	li
didnt	did	nt
edly 	ed	ly 
ening 	en	ing 
illi	il	li
mos	m	os
we will 	we 	will 
until the 	until	 the 
important 	import	ant 
ion. 	ion	. 
's	'	s
urg	ur	g
oy	o	y
school 	school	 
corrid	cor	rid
he would 	he 	would 
 thos	 th	os
jacob	jac	ob
gri	g	ri
neither 	nei	ther 
cant	c	ant
langu	l	angu
support	sup	port
worth	wor	th
it.  	it	.  
weight 	we	ight 
fist	fi	st
doctor 	doct	or 
we t	w	e t
so the 	s	o the 
rul	r	ul
ster 	st	er 
parent	par	ent
froz	fro	z
 to my 	 to 	my 
officer 	offic	er 
in your 	in 	your 
within the 	with	in the 
personal 	person	al 
o'	o	'
se and 	se 	and 
s." 	s."	 
aint	a	int
fly	f	ly
room.	room	.
choic	cho	ic
absolut	ab	solut
e.  	e. 	 
back. 	back	. 
felt the 	fel	t the 
le. 	le.	 
usual 	us	ual 
ated the 	at	ed the 
ancy 	anc	y 
noise 	no	ise 
 that you 	 that 	you 
miri	mi	ri
but, 	but	, 
ships 	ship	s 
et and 	et 	and 
pant	p	ant
nu	n	u
else	el	se
matter 	mat	ter 
from her	from	 her
previ	pre	vi
shock	sh	ock
occup	oc	cup
plant	pl	ant
country 	count	ry 
5 	5	 
giant 	gi	ant 
graph	grap	h
fright	fri	ght
 team	 te	am
it would be 	it 	would be 
aked 	ak	ed 
wo	w	o
brown 	br	own 
smell 	sm	ell 
ings. 	ing	s. 
 hair	 h	air
? the 	?	 the 
ress	res	s
passeng	pass	eng
eventually 	event	ually 
ga	g	a
 thats 	 th	ats 
itor	it	or
thern	ther	n
chance 	ch	ance 
rather	ra	ther
why	wh	y
tre	t	re
ively 	iv	ely 
grab	gr	ab
it!	it	!
figu	fi	gu
aylor 	ay	lor 
action 	act	ion 
shadow 	shad	ow 
jo 	j	o 
field	fiel	d
passa	pas	sa
part of 	par	t of 
leaving 	leav	ing 
a couple 	a cou	ple 
desk	des	k
cking 	ck	ing 
ed that	ed	 that
of th	of	 th
, but the 	, 	but the 
follow 	fol	low 
jes	j	es
 tor	 t	or
sam 	s	am 
parents 	par	ents 
attention 	attent	ion 
use th	us	e th
pill	p	ill
catch 	cat	ch 
field 	fiel	d 
 hen	 h	en
cy	c	y
none 	n	one 
 thousand 	 thous	and 
stick	st	ick
me that 	m	e that 
a hand	a h	and
struction	stru	ction
speed 	spe	ed 
grinn	gr	inn
life	li	fe
ior 	i	or 
dozen 	doz	en 
intellig	intel	lig
requ	re	qu
letter	let	ter
wrapped 	wr	apped 
months 	month	s 
eres 	er	es 
yes 	y	es 
 tech	 te	ch
uncle 	un	cle 
drawn	draw	n
intro	int	ro
go to 	go	 to 
comment	com	ment
made a 	made 	a 
exper	ex	per
if it 	if 	it 
re-	re	-
rou	r	ou
pool	p	ool
air of 	air 	of 
 this time 	 this	 time 
gard	g	ard
 to do	 to 	do
ann 	ann	 
island 	is	land 
battle 	batt	le 
e of the 	e 	of the 
lifted 	lif	ted 
growing 	grow	ing 
pun	p	un
eless 	el	ess 
 no, 	 no	, 
door, 	door	, 
fear 	f	ear 
werent 	wer	ent 
ates 	at	es 
inging 	ing	ing 
rum	r	um
side, 	sid	e, 
 tot	 to	t
a half	a h	alf
as you 	as 	you 
mort	mor	t
while the 	while th	e 
cried 	c	ried 
can you 	can 	you 
american 	americ	an 
have you 	have 	you 
soldiers 	soldi	ers 
e." "	e." 	"
lepage 	lep	age 
icked 	ic	ked 
instant	inst	ant
an hour 	an h	our 
servic	ser	vic
certain 	cert	ain 
convinc	conv	inc
y. the 	y	. the 
myster	my	ster
smash	sm	ash
killed 	kill	ed 
david	dav	id
slid 	sli	d 
summ	sum	m
glad	gl	ad
, tom	, t	om
at. 	at	. 
lit	l	it
where they 	where 	they 
communic	commun	ic
might	m	ight
i have to 	i have 	to 
chez	che	z
 they are 	 they 	are 
of course 	of cour	se 
band 	b	and 
bell	b	ell
halet	hal	et
 were 	 	were 
find the 	find	 the 
can be 	can 	be 
s on 	s 	on 
appeared 	appear	ed 
suspic	sus	pic
 that is 	 that 	is 
 this was 	 this 	was 
afraid 	afra	id 
regard	reg	ard
side	sid	e
silent 	sil	ent 
everyth	every	th
was that 	was	 that 
mutter	m	utter
crack	cr	ack
relief	reli	ef
minist	min	ist
ion.	ion	.
blo	bl	o
, too	,	 too
wonder 	won	der 
deck 	de	ck 
spread 	sp	read 
door.	door	.
ms. 	m	s. 
 took the 	 took	 the 
park	par	k
as much 	as 	much 
lan	l	an
cart	c	art
ular 	ul	ar 
plain	pl	ain
in fac	in 	fac
weeks 	we	eks 
strength	streng	th
scient	sci	ent
was too 	was	 too 
peac	pe	ac
a lot 	a lo	t 
coo	c	oo
say, 	sa	y, 
loud	lou	d
ack of 	ack 	of 
 well, 	 	well, 
ous, 	ou	s, 
ding 	d	ing 
head and 	head 	and 
pray	p	ray
u 	u	 
murder	mur	der
kin	k	in
driver	dri	ver
instead	inste	ad
pect 	pe	ct 
introdu	intro	du
break 	bre	ak 
e?"	e?	"
as his 	as 	his 
an and 	an 	and 
into my 	into 	my 
comfortable 	comfort	able 
attered 	atter	ed 
gets 	get	s 
narrow	n	arrow
ets 	et	s 
georg	ge	org
by a 	by 	a 
might have 	might 	have 
hospit	h	ospit
gwa	g	wa
felix	fel	ix
inct	in	ct
but he 	but 	he 
several	sever	al
quietly 	quiet	ly 
clearly 	clear	ly 
. she had 	. she 	had 
lilly 	lil	ly 
 no 	 	no 
e tre	e t	re
lower	low	er
so he 	so 	he 
contact 	cont	act 
would have to 	would have 	to 
local 	loc	al 
outside the 	outside th	e 
 after 	 	after 
i, 	i	, 
ery 	er	y 
jaw	j	aw
heart	hear	t
ninj	nin	j
? the 	? th	e 
away.	away	.
knowing 	know	ing 
aware 	aw	are 
moments 	mom	ents 
a lot of 	a lo	t of 
week 	we	ek 
vin	v	in
.  you 	.  	you 
turned 	turn	ed 
que 	qu	e 
filled with 	fill	ed with 
le and 	le 	and 
public	pub	lic
wing	w	ing
her. 	her.	 
melody 	melod	y 
writt	wr	itt
chos	ch	os
jack 	j	ack 
success	suc	cess
cell	c	ell
audi	au	di
favor	fav	or
because th	becaus	e th
be able to 	be 	able to 
although 	although	 
down to the 	down	 to the 
insist	in	sist
knowledg	knowl	edg
.  it was 	.  	it was 
al and 	al 	and 
ny 	n	y 
went to 	went	 to 
condition	cond	ition
club	clu	b
lips 	lip	s 
looking for 	looking 	for 
asc	as	c
, and she 	, and 	she 
.. 	..	 
south	sou	th
also	al	so
object	ob	ject
using 	us	ing 
stretch	stret	ch
storm	stor	m
content	cont	ent
something to 	someth	ing to 
able. 	able	. 
water. 	wat	er. 
quarter	quar	ter
fort 	for	t 
looked like 	looked 	like 
 today	 to	day
definit	defin	it
rub	ru	b
ed, he 	ed, 	he 
eric 	er	ic 
photo	phot	o
-t	-	t
glanced 	glanc	ed 
sharp 	sharp	 
opposite 	oppos	ite 
more than	more th	an
where he 	where 	he 
ken	k	en
way to the 	way	 to the 
unable to 	un	able to 
i'd 	i'	d 
guid	gu	id
sudden 	sudd	en 
ust	u	st
ly to 	ly	 to 
ies of 	ies 	of 
huge 	hu	ge 
intend	int	end
pour	p	our
room and 	room	 and 
catalin	cat	alin
rescu	res	cu
possibly 	possi	bly 
ing. he 	ing	. he 
beyond 	bey	ond 
emper	em	per
 thirty 	 thir	ty 
pir	p	ir
older 	old	er 
itself 	it	self 
pass 	p	ass 
a very 	a 	very 
zanas 	zan	as 
shut 	shu	t 
assass	ass	ass
skill	sk	ill
gently 	g	ently 
spot 	sp	ot 
resist	res	ist
closer	clos	er
wild	w	ild
dressed 	dres	sed 
lives 	li	ves 
darkness 	darkn	ess 
villag	vill	ag
 twenty-	 twent	y-
investig	invest	ig
away from 	away 	from 
ise	i	se
jones	jon	es
we're 	we	're 
said to 	said	 to 
out of his 	out 	of his 
belong	bel	ong
bloody 	blood	y 
back of the 	back 	of the 
s his 	s 	his 
mut	m	ut
agu	ag	u
urb	ur	b
his t	his	 t
yard	y	ard
 them. 	 them.	 
neil 	ne	il 
sarah 	sar	ah 
e that	e th	at
nothing to 	noth	ing to 
grim	gr	im
allison 	alli	son 
ded 	d	ed 
up his 	up	 his 
eat 	e	at 
a's 	a	's 
, with 	, 	with 
hidden 	h	idden 
dust	du	st
, trying to 	,	 trying to 
eld 	el	d 
e.  the 	e. 	 the 
 hes 	 h	es 
suf	su	f
have the 	have 	the 
heard	hear	d
; i 	;	 i 
a ser	a s	er
rafe 	raf	e 
seeing 	see	ing 
 thick 	 th	ick 
s to be 	s to 	be 
leather 	le	ather 
fifteen 	fif	teen 
!!	!	!
would you 	would 	you 
argu	ar	gu
e.  i 	e	.  i 
moon	mo	on
 she was 	 she 	was 
 hum	 h	um
station	st	ation
charac	char	ac
sant	s	ant
ure, 	ure	, 
pt 	p	t 
carry 	car	ry 
a huge 	a h	uge 
ing through	ing	 through
kur	k	ur
then 	th	en 
mrs. 	mr	s. 
neigh	ne	igh
 heav	 he	av
apprec	app	rec
collap	col	lap
aband	ab	and
gain	g	ain
el, 	el	, 
n't	n	't
daughter	daugh	ter
cott	co	tt
ized 	iz	ed 
guil	gu	il
before they 	befor	e they 
sym	sy	m
smok	sm	ok
main	m	ain
various 	vari	ous 
exha	ex	ha
ench	en	ch
somehow 	some	how 
ing on 	ing 	on 
machin	mach	in
 at the 	 	at the 
smile. 	smil	e. 
s.  the 	s. 	 the 
umbled 	umbl	ed 
evid	ev	id
gaze 	gaz	e 
hours 	hour	s 
dre	d	re
soli	so	li
 there are 	 there 	are 
odd	o	dd
all that 	all	 that 
ity of 	ity 	of 
alejo 	ale	jo 
a mon	a m	on
of course	of cour	se
 all 	 	all 
squeez	sque	ez
changed 	chang	ed 
found the 	found	 the 
ipp	ip	p
echo	e	cho
seems 	seem	s 
hot 	h	ot 
which was 	which 	was 
grac	gr	ac
key 	k	ey 
 just 	 	just 
ing of the 	ing 	of the 
port 	p	ort 
 how 	 	how 
normal 	norm	al 
lived 	li	ved 
i would 	i 	would 
gor	g	or
ers were 	ers 	were 
reach 	re	ach 
bomb	b	omb
remain 	rem	ain 
degre	de	gre
beat	be	at
replac	re	plac
progr	pro	gr
flag	fl	ag
discuss	discus	s
destin	de	stin
old man 	old 	man 
sorry, 	sor	ry, 
mistak	mist	ak
me.	m	e.
s was 	s 	was 
all, 	all	, 
 the sam	 the s	am
, he said 	, he 	said 
despite 	desp	ite 
igar	ig	ar
in one 	in 	one 
chance to 	chanc	e to 
fifty 	fif	ty 
starting to 	start	ing to 
seas	se	as
stared at 	star	ed at 
slow 	sl	ow 
wearing 	wear	ing 
wouldn't 	would	n't 
pilot	pil	ot
slamm	sl	amm
loved 	lo	ved 
east 	e	ast 
up. 	up.	 
what?	what	?
avoid	avo	id
porth	por	th
must	mu	st
 chris 	 ch	ris 
meant 	me	ant 
locked 	lo	cked 
for some 	for 	some 
 that's 	 that	's 
desk 	des	k 
would have been 	would have 	been 
mostly 	most	ly 
me the 	me th	e 
cand	c	and
watched the 	watch	ed the 
oop	oo	p
bush	bu	sh
problem 	proble	m 
tried to 	t	ried to 
sergeant 	serge	ant 
e of a 	e of 	a 
minute 	minut	e 
project	pro	ject
sty	st	y
cou	c	ou
detect	det	ect
exe	ex	e
circl	cir	cl
 then, 	 then	, 
ulf	ul	f
ually	u	ally
rect 	rec	t 
zyn	z	yn
mod	mo	d
bearl	bear	l
e. it 	e. 	it 
drug	d	rug
uh	u	h
collect	colle	ct
human 	hum	an 
brown	br	own
 tommy 	 tom	my 
e:	e	:
gall	g	all
mission 	miss	ion 
ation and 	ation 	and 
 hold	 h	old
whose 	wh	ose 
, but she 	, but 	she 
me? 	me?	 
nur	n	ur
expos	ex	pos
es. th	es.	 th
private 	priv	ate 
doors 	door	s 
brac	br	ac
accept	acc	ept
merc	mer	c
en. 	en.	 
greet	gre	et
amoun	am	oun
remaining 	remain	ing 
bound	b	ound
ing from the 	ing 	from the 
on your 	on 	your 
dawn	d	awn
smoke 	sm	oke 
almost	al	most
st time 	st	 time 
super	sup	er
counc	c	ounc
sad	s	ad
government 	govern	ment 
damn 	damn	 
ures	u	res
chap	ch	ap
a-	a	-
observ	ob	serv
 teach	 te	ach
necessar	necess	ar
whom	wh	om
ride 	ri	de 
itself	it	self
fool	f	ool
, i was 	, i 	was 
fresh 	fre	sh 
rand	r	and
milli	mil	li
find out 	find 	out 
purchas	pur	chas
right?	right	?
apparently 	appar	ently 
barn	bar	n
cord	cor	d
ians 	i	ans 
ed toward the 	ed	 toward the 
doctor	doct	or
 track	 tr	ack
familiar 	famili	ar 
prog	pro	g
s.  	s. 	 
ed, i 	ed, 	i 
execut	exe	cut
with a s	with 	a s
plent	pl	ent
grey 	gre	y 
worn	wor	n
advant	adv	ant
, thats 	,	 thats 
group of 	group	 of 
e tow	e t	ow
map	m	ap
 tomorrow	 tomor	row
e though	e th	ough
ed an 	ed 	an 
thern 	thern	 
liz	li	z
eleanor 	elean	or 
for your 	for 	your 
for their 	for	 their 
liqu	li	qu
ing. th	ing.	 th
suffer	suf	fer
init	in	it
one that 	on	e that 
, but it 	, but 	it 
it took 	it	 took 
him to 	him	 to 
civil	civ	il
attach	att	ach
ouched 	ou	ched 
level 	le	vel 
ed to a 	ed to 	a 
vessel	ves	sel
ical	ic	al
past the 	past	 the 
and their 	and	 their 
just a 	just 	a 
master 	mast	er 
ve. 	v	e. 
ah, 	ah	, 
advanc	adv	anc
ffl	f	fl
tra	t	ra
made the 	made th	e 
particular	particul	ar
lower 	low	er 
." she 	."	 she 
.  but 	.  	but 
i will 	i 	will 
life, 	lif	e, 
thought	though	t
den 	d	en 
i hope 	i h	ope 
fallen 	fall	en 
head. 	head	. 
wolf 	wolf	 
kar	k	ar
billy 	bil	ly 
corner 	corn	er 
wed 	w	ed 
s and the 	s 	and the 
avail	av	ail
helped 	hel	ped 
 turned and 	 turn	ed and 
and she 	and 	she 
but they 	but	 they 
 while 	 wh	ile 
away. 	away	. 
on the other 	on the 	other 
instead of 	instead 	of 
suspect	sus	pect
natural 	natur	al 
night, 	night	, 
dock	do	ck
nodded 	nodd	ed 
scann	sc	ann
silenc	sil	enc
in order	in 	order
ated. 	at	ed. 
hus	h	us
form 	form	 
likely 	lik	ely 
narrow 	n	arrow 
orang	or	ang
conce	con	ce
present 	pres	ent 
ras	r	as
ital	it	al
ier 	i	er 
res 	re	s 
subject	sub	ject
roar	ro	ar
able.	able	.
expression 	express	ion 
anks 	an	ks 
uri	u	ri
 that had 	 that 	had 
beginning to 	beginn	ing to 
i had to 	i had	 to 
jung	j	ung
were the 	were 	the 
english	eng	lish
angry 	angr	y 
giving 	giv	ing 
 there was a 	 there 	was a 
thre	th	re
refer	re	fer
tern	ter	n
about his 	about 	his 
over her 	over	 her 
cast 	c	ast 
 them to 	 them	 to 
ling	l	ing
on to 	on	 to 
al. 	al.	 
strip	st	rip
pin	p	in
somehow	some	how
showed 	show	ed 
gif	g	if
son, 	son	, 
watching 	watch	ing 
 tight	 t	ight
mr 	mr	 
flat 	fl	at 
ffic	ff	ic
door. 	door	. 
frustr	fru	str
prim	pr	im
exhaust	exha	ust
cliff	clif	f
 theyd 	 they	d 
blind	bl	ind
ial	i	al
did he 	did 	he 
and a 	and 	a 
we could 	we 	could 
 talk to 	 talk	 to 
dry 	dr	y 
 turning 	 turn	ing 
spid	sp	id
 which 	 wh	ich 
ular	ul	ar
ty-	t	y-
finally, 	fin	ally, 
grandp	grand	p
mc	m	c
strik	stri	k
doubt 	doub	t 
ed? 	ed?	 
cloud	clou	d
ww	w	w
ester	est	er
supposed to 	suppos	ed to 
soft 	sof	t 
awk	aw	k
smiled. 	smil	ed. 
gang	g	ang
stared 	star	ed 
wife 	wif	e 
ed through 	ed	 through 
out. 	out.	 
ket	k	et
gate 	g	ate 
a tr	a	 tr
wand	w	and
eer	e	er
reflect	refle	ct
bridg	bri	dg
wave 	wa	ve 
put the 	put	 the 
in front of the 	in front 	of the 
signal	sign	al
saying 	say	ing 
assist	as	sist
! she 	!	 she 
make it 	make 	it 
on him	on	 him
 held 	 hel	d 
whol	wh	ol
," she 	,"	 she 
rit	r	it
scarburg	scar	burg
 he could 	 he 	could 
know that 	know	 that 
lung	l	ung
maint	ma	int
on that 	on	 that 
queen 	que	en 
ing through 	ing	 through 
pack 	p	ack 
so many 	so 	many 
ceed	ce	ed
chin	ch	in
electric	elect	ric
body. 	bod	y. 
anyway, 	any	way, 
? what 	?	 what 
had no 	had 	no 
grav	gra	v
silver 	sil	ver 
 the tre	 the t	re
 from 	 	from 
all of the 	all 	of the 
ing into the 	ing 	into the 
know, 	know	, 
wild 	wil	d 
unk 	un	k 
assign	as	sign
head, 	head	, 
waiting for 	wait	ing for 
goes 	go	es 
suppli	supp	li
like that	like th	at
glass	gl	ass
sir, 	sir	, 
what she 	what 	she 
int of 	in	t of 
y. he 	y	. he 
polic	po	lic
umin	um	in
around and 	around 	and 
palm	pal	m
phon	ph	on
made it 	made 	it 
entranc	entr	anc
 they could 	 they 	could 
agent 	ag	ent 
definitely 	definit	ely 
rift 	rif	t 
distr	di	str
for my 	for 	my 
ing the t	ing the 	t
right. 	right	. 
t was 	t 	was 
nodded. 	nodd	ed. 
serious	ser	ious
funn	f	unn
remembered 	remember	ed 
ifi	if	i
send	s	end
red to 	red	 to 
brush	b	rush
 tu	 t	u
recover	rec	over
 the st time 	 the 	st time 
slowly	slow	ly
worth 	wor	th 
ency 	enc	y 
pursu	pur	su
hunt	h	unt
massive 	mas	sive 
occur	oc	cur
what they 	what	 they 
embarr	em	barr
may be 	may 	be 
by the time 	by	 the time 
since the 	since th	e 
spin	sp	in
cow	c	ow
french 	fren	ch 
distanc	dist	anc
e; 	e;	 
heard the 	hear	d the 
repl	re	pl
s to	s	 to
dub	du	b
, was 	, 	was 
close	clo	se
flew 	flew	 
there 	th	ere 
get a 	get 	a 
wise 	wi	se 
 heard 	 hear	d 
years ago	years 	ago
jos	j	os
madam	mad	am
efor	e	for
yourself 	your	self 
."  	." 	 
get to 	get	 to 
face and 	fac	e and 
in the t	in the 	t
idi	id	i
mountain 	mount	ain 
drew 	drew	 
sour	s	our
sort	s	ort
 and i 	 and 	i 
laughed 	laugh	ed 
flight	f	light
exic	ex	ic
 town	 t	own
find a 	find 	a 
entered 	ent	ered 
bridge 	bri	dge 
fathers 	fath	ers 
aking 	ak	ing 
request	re	quest
beam	be	am
 how to 	 how	 to 
only the 	only	 the 
pred	p	red
defen	def	en
es, the 	es	, the 
tom	t	om
wish 	wi	sh 
see that 	se	e that 
you have to 	you have 	to 
iled 	il	ed 
movement 	mov	ement 
fram	fr	am
lin 	l	in 
. after 	. 	after 
ily. 	il	y. 
grabbed 	grabb	ed 
sure th	sur	e th
as far 	as 	far 
dear	d	ear
paid 	pa	id 
. they were 	.	 they were 
burst 	bur	st 
atter 	at	ter 
extrem	ext	rem
as to 	as	 to 
up with 	up 	with 
interest 	inter	est 
stain	st	ain
 tell you 	 tell 	you 
; he 	;	 he 
na	n	a
y, he 	y, 	he 
pping 	pp	ing 
individ	indi	vid
even the 	even	 the 
house. 	hou	se. 
rapid	rap	id
ially 	i	ally 
judg	ju	dg
wrist	w	rist
died 	di	ed 
es. i 	es	. i 
me.  	me	.  
he's 	he	's 
anx	an	x
as long 	as 	long 
ate. 	at	e. 
knew the 	knew	 the 
hurt 	hur	t 
make the 	make th	e 
what do you 	what 	do you 
afraid	afra	id
ord 	or	d 
bright	b	right
morning	morn	ing
fly 	f	ly 
dani	d	ani
robb	ro	bb
building	build	ing
beat 	be	at 
so that 	so	 that 
information	inform	ation
 teeth	 te	eth
iate 	i	ate 
possess	pos	sess
 twi	 t	wi
a few	a 	few
lis	li	s
examin	exam	in
wondering 	wonder	ing 
looked down 	looked 	down 
national 	nation	al 
eyebrow	eye	brow
 that. 	 that	. 
day.	day	.
driver 	dri	ver 
record	rec	ord
blur	bl	ur
. these 	. th	ese 
prote	pro	te
 hop	 h	op
addition	add	ition
wake 	wa	ke 
ocked 	oc	ked 
offered 	off	ered 
class	cl	ass
, this is 	, this 	is 
 try 	 tr	y 
for a few 	for 	a few 
screen 	scre	en 
iron 	ir	on 
jenn	j	enn
drink 	dr	ink 
bank	b	ank
arent 	ar	ent 
hard to 	hard	 to 
counter	coun	ter
selv	sel	v
gig	g	ig
. if 	. 	if 
a bre	a b	re
daughter 	daugh	ter 
roof 	ro	of 
powerful 	power	ful 
i-	i	-
whether 	whe	ther 
pati	pat	i
a hand 	a h	and 
bent 	b	ent 
sac	s	ac
are we 	are 	we 
hung 	h	ung 
of course, 	of cour	se, 
once th	onc	e th
c 	c	 
engag	eng	ag
chall	ch	all
fit 	f	it 
s, she 	s, 	she 
! th	!	 th
deliver	deli	ver
alive 	al	ive 
before i 	before 	i 
instruct	in	struct
in a c	in 	a c
placed 	plac	ed 
reck	re	ck
off his 	off	 his 
a great 	a 	great 
back at 	back 	at 
said.  	said	.  
vision 	vis	ion 
took	t	ook
 hours 	 hour	s 
from their 	from	 their 
i hav	i h	av
ring 	r	ing 
yester	y	ester
ill be 	ill 	be 
er had 	er	 had 
plast	pl	ast
it. i 	it	. i 
jamie 	jam	ie 
mix	mi	x
mexic	m	exic
he'd 	he	'd 
with that 	with	 that 
icop	ic	op
; but 	;	 but 
weapons 	weap	ons 
know what	know wh	at
es. he 	es	. he 
pois	po	is
it to the 	it	 to the 
prop	pro	p
cro	c	ro
happy 	happ	y 
before she 	before 	she 
served 	ser	ved 
press 	pres	s 
fresh	fre	sh
se th	s	e th
it was the 	it 	was the 
presence 	pres	ence 
sequ	se	qu
ground, 	ground	, 
well-	well	-
warrior 	warri	or 
before, 	befor	e, 
iment	im	ent
dangerous 	danger	ous 
imagine 	imag	ine 
out a 	out 	a 
bother	b	other
me. i 	me. 	i 
sit	s	it
glance 	gl	ance 
falling 	fall	ing 
finger	fing	er
charge 	char	ge 
y, i 	y, 	i 
again and 	again 	and 
 one 	 	one 
pulled the 	pull	ed the 
gether 	ge	ther 
covered 	cover	ed 
 told	 t	old
computer 	comput	er 
obvious	obvi	ous
deep breath	deep 	breath
mik	mi	k
scrat	sc	rat
. what	. wh	at
yes. 	y	es. 
simil	sim	il
explod	expl	od
ils 	il	s 
sul	s	ul
 hur	 h	ur
 twel	 tw	el
bum	bu	m
cost	co	st
snow	s	now
 they would 	 they 	would 
es in 	es 	in 
rob	ro	b
! the 	!	 the 
gle	g	le
retri	ret	ri
around his 	around 	his 
unless 	un	less 
youd 	you	d 
univers	uni	vers
glar	gl	ar
horiz	hor	iz
had not 	had 	not 
 on 	 	on 
gasp	gas	p
blanc	bl	anc
stag	st	ag
teen	te	en
y. the 	y. th	e 
grasp	gras	p
autom	aut	om
el and 	el	 and 
wound 	w	ound 
under his 	under	 his 
e them	e th	em
se to 	s	e to 
dust 	d	ust 
going to	go	ing to
at the sam	at the 	sam
women	wom	en
for this 	for	 this 
when it 	when 	it 
. and 	.	 and 
stupid 	stup	id 
anno	an	no
means 	me	ans 
stupid	stup	id
glanced at 	glanc	ed at 
stuck 	stu	ck 
 thom	 th	om
10	1	0
seik	se	ik
raw	ra	w
produc	produ	c
nose 	no	se 
members 	mem	bers 
e. you 	e. 	you 
make a 	make 	a 
wet 	w	et 
with your 	with 	your 
and to 	and	 to 
seem to 	seem	 to 
umn	um	n
surface 	sur	face 
kim 	k	im 
an. 	an	. 
perfectly 	perfect	ly 
na 	n	a 
contact	cont	act
lose 	l	ose 
ira 	ir	a 
rying to 	ry	ing to 
 from the 	 	from the 
busy 	bu	sy 
oce	oc	e
whatever	what	ever
got the 	go	t the 
y, the 	y	, the 
 i was 	 i 	was 
right now	right 	now
gear	g	ear
hundred	hun	dred
of our 	of 	our 
confirm	con	firm
fighting 	fight	ing 
replied, 	repli	ed, 
visible 	visi	ble 
; and 	;	 and 
do you think 	do you	 think 
knock	kno	ck
cause 	caus	e 
 to this 	 to	 this 
s from 	s 	from 
occasion	occas	ion
 high	 h	igh
ve, 	v	e, 
explor	expl	or
surely 	sure	ly 
of an 	of 	an 
bullet 	bul	let 
stretched 	stret	ched 
piece of 	pie	ce of 
despit	des	pit
morning, 	morn	ing, 
years. 	year	s. 
worried 	wor	ried 
is to 	is	 to 
s! 	s!	 
thus	th	us
mech	me	ch
ure of 	ur	e of 
dern	der	n
henrik 	hen	rik 
protect 	prote	ct 
game 	g	ame 
half-	half	-
special	speci	al
worri	wor	ri
you think 	you	 think 
ate the 	ate th	e 
orm	or	m
mart	m	art
rifi	ri	fi
sne	s	ne
attempt to 	attemp	t to 
fem	f	em
major 	maj	or 
print	pr	int
aram	ar	am
green	gre	en
know where 	know wh	ere 
royal 	roy	al 
yellow 	yell	ow 
rever	re	ver
will have 	will	 have 
current 	curr	ent 
backward	back	ward
grown 	gr	own 
 this, 	 this	, 
chamber	cham	ber
watching the 	watch	ing the 
dagg	d	agg
evening 	even	ing 
aircraft 	aircraf	t 
ia	i	a
ure. 	ure	. 
u.	u	.
job 	job	 
ing from 	ing 	from 
a hundred 	a hun	dred 
pointed 	point	ed 
littl	l	ittl
shutt	shut	t
an hour	an	 hour
written 	writt	en 
choo	ch	oo
15	1	5
cous	c	ous
jan	j	an
surprise 	surpri	se 
stomach	stom	ach
brand 	br	and 
gal	g	al
too 	to	o 
lak	l	ak
animal	anim	al
assa	as	sa
home. 	hom	e. 
open the 	open	 the 
grabbed the 	grabb	ed the 
 thin 	 th	in 
impress	im	press
like an 	like 	an 
e in 	e 	in 
web	we	b
 your 	 	your 
account	acc	ount
hand and 	hand 	and 
vict	vic	t
cave 	c	ave 
. this is 	. this 	is 
puzz	pu	zz
valu	val	u
und	un	d
ipped 	ip	ped 
ena 	en	a 
es?	es	?
up a 	up 	a 
center of the 	cent	er of the 
 the t	 th	e t
 table 	 t	able 
pilot 	pil	ot 
front of the 	front 	of the 
it wasnt 	it 	wasnt 
 throat	 thro	at
itive 	it	ive 
, their 	,	 their 
becoming 	be	coming 
e.'	e.	'
lee 	le	e 
practic	pract	ic